docid,language,num_cells,num_code_cells,num_md_cells,len_md_text
NB_26e572f53351c1221071f9eddc4e8ceb8c91a3c9be6adf4f2194dfce7b54845d,python,48,21,27,57
NB_ee98d68f2e949cd6e9ab74a1163fbb312ab55c1180b70373e4a34cfab196fa2a,python,8,8,0,0
NB_78859b9a27cc21e59842f22c3829697e63d170923f764adf76c463f73b92228a,python,6,5,1,1
NB_93cd29a2acda3cfbb267b05174fea04f6aca5f6f05cde8109ecdd7483f77c04d,python,44,22,22,176
NB_6e96074e16f7f32a1e08825ab2ad3aeb380a4e2582a8928e3ffeddc03bad747b,python,8,8,0,0
NB_583835aa5fa04dddcdf6c15dcfe4ac1d00497adfb393ae4f1c3724bd796c0c1e,python,22,20,2,2
NB_241617ea14f8b2e20e352a2bf1a76845e5d868510270c9e0cdd9bddef41c520e,python,32,17,15,58
NB_e523b69e1e216a151e3c809aa3274c77d9de84f477e9200dbb11ecdb542795d4,python,14,8,6,9
NB_ff8d5a8e2498a2e74afac7649b4db6d099009c802c35ccc8567ded94a9ac81b5,python,11,11,0,0
NB_d2c857bae52a3992b4eb2ae7676f01db40a3294e244a3685cd7327e7587bf8dc,python,39,31,8,48
NB_7fb456c1a0aa0c776490321c708a4a5f54a1ec7e51750f90dd05a50930c8dfb7,python,12,6,6,49
NB_98ea3e82bbd4ed42cee0ace9fffa268f33b039d283a7dbdebed75c20b522055a,python,5,2,3,24
NB_9b19b08fc86459955eaa3afeeec21f8afcb7e31d97f0d90b72e5e4cbba05c96d,python,31,21,10,10
NB_ad6df29ca5775423a15a107e39cffa040274514118c5e0481249a7f0871a2fd9,python,26,26,0,0
NB_bcc84158cda51afc6b74098c396f1d81a7a6a90fd7176381fa5712a8e0bcf166,python,15,14,1,1
NB_a1db4ba70a32a4b9fdfd2e9c1e137d06a67cda604af28518086bcf335f84d718,python,47,45,2,2
NB_020d7d084c6778aa849f663edf6054e0954f137090ccb8551acfc2578bb491bf,python,106,85,21,21
NB_abc8c259632cd577b57db105cca85c6e498ed435f662d306d18886167ed677b5,python,26,19,7,10
NB_6e83990b67e83c7ea15fa9a1a87eb90f59287a8f63869a58f0b7443e2202fb6a,python,84,49,35,175
NB_3421700e956365a49e539a377753f0e2ec98ef7ba667b9da06cf5246ff08a58a,python,32,18,14,148
NB_bd8399358c2e9923a61c5eb01cd35b23d90a28cbb103c2183284debd9e855a6a,python,36,19,17,8
NB_2ad3e64567bc0c3238972f2d47a4cf5c33c9730ceaba9854295d73b537a8dc2d,python,108,91,17,19
NB_2ddb08b3df64776f8649a1e52483b1c15bdc08f97a6970002947b2c73a758555,python,15,12,3,3
NB_d9efb10f2a190887645bb24fb0c50622964faa26b7069a49c33630484d0fae52,python,49,23,26,309
NB_daf0f37606fa0b358f4bf78fd5c3a5be1129eb749435c321104e583423928ac4,python,15,12,3,3
NB_2fd607c30e6123fc6414fb8788aae8d258aac176e82ef791996ee969f3bac042,python,94,37,57,333
NB_3fb819a02678c3158c7b7062383b3c401cdc03a0b91537c9ff609eb7fc43c459,python,22,12,10,30
NB_c47a59b46b6a49a45a3f8eabe94dd1114c018c3765e91a71e91e0a07fe6f1bc5,others,20,14,6,7
NB_926cf93663d2985f8c5153e50ba4b54c3aae82a7cb701cce8b620e6ad8c18d26,python,13,9,4,4
NB_9ccc76f56fd65d906ef3417bf8ec8f573af4aa59483f48382e60450b855eece2,python,43,22,21,21
NB_a99603e9b784b8c35a9a58d799044096a412357534b526841f98bb6b10c0fbb0,python,13,11,2,2
NB_4af96b62e43e1da86d962b92ff5bb8e0552e5fd39fe85c9cda5dfd6c8eb92ca9,python,45,34,11,11
NB_3173b93d390c164ed6eaa7fcb34c481e7d6842cb14c583e69f9cf0370d2eb56b,python,51,34,17,25
NB_8d68a0ca8e1289412b2e639070cc76ab123add62e813a21276fa36c1487b24a5,python,35,35,0,0
NB_ffc23881e3f004a9b4a2997d4e2ac343d34b3086e073b37a75fd11be54feb47f,python,18,12,6,17
NB_562b7d3d784b512ffa3f0141a250fe21b0fee0c4c0eb00b1dd77d0b5d875c338,others,94,55,39,48
NB_879171089ea8799e75568a3b2e6c9b1aae9451491df32ba37293323ef552251f,python,6,5,1,1
NB_1601647633337356415d8b7a38c30bb8972befed188967501de964656712180b,python,37,19,18,175
NB_4330c7302d41a5a6b86058d8869cc003c99b5bfec99e110131c28b3584dd9613,python,35,15,20,303
NB_5684b391b21f6c410cc531d051f083014479f380fedf743b533250215528d7c8,others,38,16,22,28
NB_ee3c90b0090c72b72f0b3baec0379303541d6766a21c2340f2b66d5195cbb5b0,python,27,19,8,319
NB_25abb5ad848592a32802c3f8e1695bcdcb09a80de9c2c047c9e83ad1bec00fd0,python,72,44,28,42
NB_4d16ddcd652532e9a0b429c9771f0c7073a244f022d31dbc5e35ed934a7527db,python,7,7,0,0
NB_f13b011523bfcbf27cc07a3cf821cd82b83f725522ffef8be6f00737ac0a8fe4,python,30,18,12,75
NB_d4a831ef8936289b35db410de7c5eb36285481e481d6f6737019bd177eb26790,python,19,9,10,17
NB_ac2c134a103fcda4b7c90647eb4d4351529a316d89b81fa53bab8928b23d79b4,python,15,15,0,0
NB_80afc717058a903463c5c3184c08657a052a4e66de2a109c7a5a3668e0eef485,python,32,24,8,13
NB_7c8a3d0872cf951a321ad91f2d8e31a15dfbffc05a182432ca143eacb5e4ebd2,python,25,11,14,376
NB_6bca3d77892eab6fda8b9b993e11b7cf3d6944a1662426c76c06543108b846dd,python,33,33,0,0
NB_ab6023170831f3035d17ea185a049d1fb42681304bef91a4e8defdc26f53a1ce,python,10,5,5,63
NB_e5117c15ff2639ae58108715a1b7fb562063050ca82f8b528bafef275afd3cb3,python,3,3,0,0
NB_d228a5117305ee53802e41f81844891b1f01b47713e3d905e26f090be219781f,python,14,9,5,5
NB_63c14c81f1eac0d97439b31fae77ebcb435be3b68a909f987994c40afc53c33f,python,100,53,47,67
NB_a48f1d7be9e83866e789273575494ca6c04ddffd4a68a0a7a4305bbee733f18f,python,14,8,6,51
NB_1364fb5ed253b63bbafadebac693db55c9777a6738b292624f40eeb28bd70ef6,python,12,5,7,87
NB_b148b1c9bc25559a03cba1d9f1f78915dd95bd8e5f60632a8444464f826fa5cc,python,87,70,17,17
NB_c73dffe3b70c250d005cac48ae5d4a5590bf16e9be22a50ec2a64a66cc0ab538,python,56,48,8,8
NB_c05a4b8296cc45f4d970eafef809b33a6bd04ae963b5d5f14eb9127a7b800318,python,1,1,0,0
NB_ada5e73198ba2231c550ecd15d95cf3ce0a69345879a6fb0e38bee91d57cff9f,python,8,8,0,0
NB_5d0b8a77b4c2d1d7b8fd23683ca7180ad834fc72f3f4d9574aabf06970bfec9a,python,27,27,0,0
NB_b62c19dfc691f145a11a4c7f186f6062705a08f5116fd070108e1ae39579697e,python,153,144,9,9
NB_2585a66dad3475113102cf055bd1d0797801e6bcd7a0b8d5089acc5e05a503e7,python,15,10,5,38
NB_3fbbc50b8f7fc8bc3ddb575428721c2dd85bfcc82317d9186dea22b0d5cd2a0b,others,51,29,22,25
NB_fbe23591c2c682a540aab85896f7a2df773c61cc45b806a4396875c3dd60dffa,python,72,42,30,274
NB_9969d348ec2dd9e82dfaacdc1e60a3c5c96ee5f73d445c3ed5f4987a88c994c8,python,3,3,0,0
NB_918051d6a694c8390f5ac9c4c83df9723c115a8668631163c596079d81101a52,python,11,11,0,0
NB_84dd41185fd49da0e26bbe278b2d707a5677cbd9ee2956cd295c340fe3e8848a,python,36,15,21,347
NB_fb90a463025a98ad50b83d3c2101aad744655db3197bbd36bd07fdcd6bff0018,python,6,4,2,2
NB_33980f3ee1790b7cf470af9480659d78a15967869623812208396bfdf2f9d868,python,47,21,26,47
NB_14ccfdfa6469b2c8f96f53fe28e2e54c050199e83f1029a8b1affb6013b22ef3,python,12,9,3,3
NB_514b90b77a7637d493ff342b5924cc5e27e339c412e1944d8d1dcff10e4ce5e7,python,20,11,9,30
NB_cbc08702bc994a7f751659714c0d319c8dea96c305ac3a072d09ff0b48a82530,python,4,2,2,24
NB_f59c7c79e14b09cd879400d276822bc104e97f4ce1b02a2f444fb0b5fa5d6185,python,5,2,3,24
NB_7373cea2ff5cdf364d857dee0ab3fc6010797f298a6928a8d87ccfff3d47a20a,python,51,34,17,25
NB_4031df746a545c5fffb3ca3357d5993ab8e6a0f45e08470776eaf1e36bccf6b0,python,55,23,32,272
NB_66fd7e512d3b08afbe7c249cfab9681021e1e5819bad7865f1ca85da935af5d9,python,29,10,19,54
NB_7df73e59c77a9fb2bd5cb8c5caeb0627d6def21ad5625389692e3c30b8a542dc,python,15,6,9,253
NB_99bb82d55df3aef5cb9f59fc33708ed097a319a8e873b547be718caefa103ecc,python,9,9,0,0
NB_9ba2ef545bb30dca970698d0ef8639a91a017da847dc21d73c6741f2a029efd8,python,34,34,0,0
NB_f8e08a13889927c9b6e391616dfa4d64f52df3038a770a2710d05b65133896bd,python,12,6,6,98
NB_8a44c8481d212be7770993bff6a542360c3107f6ffbaf422197225d26285cad6,python,10,10,0,0
NB_454f0e5e6ac54f479fb722915ac52830cdf5a882a50013fd7ecc6d990135e434,python,8,5,3,19
NB_ec276258f210fed21fdc2ba7062072ab09f6a6186716084eb4bcb3399a9aaa24,python,11,6,5,5
NB_e85d164adecd2d0a735ecd1ca387f4aa24bdeacfe018436c0ceb2a2bbf53bbfa,python,33,33,0,0
NB_064b7d8076c1fb8818ceaf72d23d3a78f16c75ced8748ff2fd562d8bdd0dd26d,python,20,9,11,14
NB_d9e87205ff860efbaea73280bab81151f65eff6a63b2bc82d6c91dc03c9dcf48,python,52,18,34,82
NB_71a7e810f5eea2dc1fc118fa1765085ee94bc0e10f251c45762b72453240badd,python,2,1,1,22
NB_44a5c493e5be480b4f6e9f94189c6f10e7a384b8c194d09e69667e6fade6b640,python,2,2,0,0
NB_2d30035d88426b54a9c3c5d9ec98c138b4e64c26e68029035010f6b954c11fe6,python,6,5,1,1
NB_111b867c0a5019557693d6f4413766e3c00be7bf251ed261a8f64093efac01fa,python,53,21,32,542
NB_d534e50ea84b571d97dc643a8ab8671a3a8397b8d4ab1dcb46c11730b4c76813,python,20,18,2,7
NB_ec883a912e2a7d1ef597dc245ba7ea2f39e49b21d8c039b087481875e729c9c4,python,121,98,23,26
NB_43183513fc34bc00d010e0254b8030f47f2aab8e074c097c77b67d17e81a1d67,python,12,4,8,67
NB_a58f98ea7658a7386d8021f9781e0bd5431adfd69101ace1dbbc9cfb4e820ca5,python,7,6,1,1
NB_a56fd30bb7793736f9a87a64d507822f2300e791c265314d0300fc3856661a84,python,5,5,0,0
NB_bf23c6e09dc4f7e69bb8fb7f809b07160dab151d30e35c05cd7b4eec53f40307,python,82,52,30,92
NB_ef2dec236a04f000713250b3cee91858daec00c7997cfb4498f2a4c4a9fb4a19,others,52,20,32,179
NB_53694682585e6373485e365d30fce8eb41ee2e4070c5468461e1f14f302a543b,python,45,30,15,28
NB_d124f3b1999f18296bc69e2ef43d2459e3a811c36b7e3caea58709360c49f97c,python,20,19,1,1
NB_4a430b42a9096162e8c60300da5a88f42e17877ecdb9d01bfd5f1cac1723c4a6,python,13,13,0,0
NB_7c624bda15162d9271f7d44f4ef966a43537ffb4f7798dc6059b65b1b04c8b37,python,7,7,0,0
NB_9eaa421a7af46af2d69e5d09e380e7766885fec473fdae951a9aa86dc1b30f9b,python,6,6,0,0
NB_17d92999e456f98ebc2be5cc2afa0858daccb1d77263fac3e03b4fc3aa04d850,python,18,12,6,17
NB_d93de7c76aef5dee8e795887830a48da35fdf476b2817bae3a54cc991c255d22,python,517,399,118,125
NB_03788267b0b963df657db74135219a71e19db93f116cad4146baebdc7cc33170,others,78,45,33,37
NB_727af7a7fdef98e1f8b9175035f5a929b22141671fb7e0a9b7767cb68f4acb05,python,39,34,5,5
NB_c24a1180679512399bac0a1424921b3e80f6a0dfab7b2983734ed1df75592f86,python,27,27,0,0
NB_6d9b226936a228c8a497daa1da91333f8197a7e6dc715ed919592d6186855d39,python,24,24,0,0
NB_8067d0f615de052caf254fa110a35d21373602793db947878a4512408c3edbaa,python,21,17,4,4
NB_cd8956c66698794c6b508b3f637e4fe9aeb628abd3eeac11f628e369932bb3e6,python,10,10,0,0
NB_963a37827d136177daabd5ae6ff3fdf4bd3779ae0ee4f16eeb184dd97b795af1,python,18,8,10,133
NB_6659e12c6e4f8a91c742364b7f442baee2c389d315625d9c45dfce32e519d7f6,python,39,30,9,29
NB_6e3e6b7260bd2a411fff1526313f3ba221b08409dde862f998e95276b0201383,python,21,21,0,0
NB_2aa01bd85074ccfe6088872fbe5d759778accf15da49dd4571cf48e938aad45f,python,33,19,14,35
NB_81971bd06c6b55b2eca86030d501e0122ae924ee0bf8e96089afdd33a9866fc6,python,23,10,13,98
NB_f4e7624079392cb04dedbc0f46ddf3d8e7c6f67340c19634b5d5405cbfeb1b9c,python,25,25,0,0
NB_33ad3ac0d370e17b3cc2aac342a204cfbf60549d3ddc0fcc563c50050fd48116,python,16,8,8,8
NB_7c1503bd03b2a79e16bc1320ce6bdd87a241fb29a79d32214a9686a4b214d075,python,10,10,0,0
NB_2332448fcdaf892fb298bc2e4d475e15c1a50c1fead88b8945b988fbdbb7db42,python,63,63,0,0
NB_5b2228c18c94451606bbd5825887a3e2134080cfadbb5d51d1f13d2bcbaacac2,python,20,14,6,6
NB_849f2879b8684015a27b4cb49d6299b6fe889cc46ef70a6bd5bbe46d43c5ac26,python,39,32,7,9
NB_cef9424827a66b15a232440429d8ba6204a4e7f368e56b1939fe87c9d1d71087,python,49,36,13,13
NB_d75495d82bf336554da4fa199a238ae5708c9422904108c79715d54359dac6d9,python,26,13,13,128
NB_71dea325e49711450f800f08e09064ace38d86c6ebeda7fd5b3620860fd5fcbf,python,16,9,7,30
NB_5383a1c959a25ac892c7930d7de4cbb5d7b1c598dfb4066a92c596902c540134,python,4,4,0,0
NB_ed8429b8fafae051109e0919c17b7cbc71f4ecc6c5494fcf5ae33ed9a6301b57,others,11,4,7,136
NB_ee8955aabf7cf7b7f4fda513f1f8b4290c16ffe78c7663a162459c0d0e019335,python,8,7,1,1
NB_eef4ceb0dfa1cc700c68e3adc93761079155430850e1ad0e1ed80462c28b27a8,python,58,47,11,18
NB_51833b25db158f2017eab3c360945a445c7ac3dda36057cabf0e8a013903e948,python,8,8,0,0
NB_c19bc5350edeb30a71b4828ef62c1deead68876099761e81e2e12f64724aee1a,others,231,147,84,187
NB_d9f03640b8652da5a4dfa48e5f03bcd89982c6a6b433e1f119af957ee641d7e1,python,44,20,24,34
NB_c6a678932c113bbdaa44b3987a5d3ed482f996cc554c5cb11697d5a241e7768d,python,54,0,54,111
NB_9a0cb076d8d21c24a2e9c30918538cba37e137f995c88f20818be5a50c09671f,python,7,7,0,0
NB_220d71b6a19cd8d851a50226aca77b45f615ef59c74ba79de4eb57c8e52e9a03,python,16,14,2,5
NB_abd37b754c8fc282c4477fe24f89fea18c33b253a5ca42e12cb594c4de5b07c9,python,11,11,0,0
NB_863e99628729b4e9965c8ba87f46f89a04b3ebd02ffa08a9379ec101e4666891,python,9,5,4,34
NB_fe040ea0d31cffd3d795e3e5a69ae89624275a303924ca3fc59f4fde854af3c5,python,25,10,15,196
NB_10af02dfed02b638b6fdbd41549e0c4c03892dbbcef434d808d5d4aacc93ea46,others,27,27,0,0
NB_b16d3b4cd6d5704b70e7003da384533e158a55ffb3fee0495909d86875eef361,python,30,22,8,26
NB_b743439ec5470a35b3d96146b026106002cc185ea20765f5eaf2320268178272,python,31,28,3,3
NB_5b5364f18a36ee988a0835d8908321f5c9ff9ce6e97669d8fbd0015ac1ede029,python,73,43,30,274
NB_80cc50e1ad708408f54a920b7ccd1a84142a6a94b9ea4325f84333422623756a,python,11,11,0,0
NB_9904cbaada8b0e846a6a686a091d381aeed429fabef480ab15aa04e17e6b1d62,python,23,13,10,106
NB_b84e64a0ee7f885dcbfec1f0f2760ae45f56c3148f8c0c81a5bdd11e6eccef3e,python,7,7,0,0
NB_f9580089753e253bd9d643dd4708030a06d8e857c86ddfad01b01dc28da50638,python,18,14,4,4
NB_e81c4af2b6db887eaadb71b7c8ff624775c072d9e31add232cb69d5497f43e02,others,0,0,0,0
NB_89c5108ab77ad42e359208d69f775d10e2958e6dd632b12f5494529638a0f42b,python,14,9,5,13
NB_36446509fa5a184b4a404bbcfeeb7ae2e898243014d86454f3fcc80dc50e4284,python,38,19,19,120
NB_72e6a8e6e4c5bef2c67aeed1981bf3992f518e13ca0c6ff99f7c9b0e82a0c31e,python,23,13,10,101
NB_b197fd947f3c6a5d72dafbfadab32697bef7abfdc4474033c3085acec02ce532,python,20,16,4,13
NB_104a29f24c1e79fc1e3d0247cd43e04f965b887eda4f405f7a4268660a4c3e56,python,6,6,0,0
NB_2aedd35f069e2ddb1c549cd1b2b1f92ae3a1400b24c20a683f7c4f432348fae0,python,10,6,4,4
NB_0d73d7eb11bb85c03a398dab7b03ee2e619b9988e153afc41f7d909dc2a4d380,python,23,14,9,52
NB_41622e0a20b565ad325b954ff5c12f5bb410567220bab4b65b90183c4c50dacd,others,69,36,33,39
NB_4165a4abcec3904410e39bd3e207daa12a21127eb543d3a886b5521250cabf2a,python,25,23,2,5
NB_fc62a822277fdcefd9a6f2294244cfd4abedf339213449bc32d54b8ba47bb13a,others,0,0,0,0
NB_8196926bbd139761730a406d080b71893828740d46d71ff914378c4c6caa556c,python,18,8,10,93
NB_4d4255230251ac36815a4d199faa331ab2657904a5692453714c9304bb5bb784,python,31,22,9,36
NB_b3455c499e834eddd14c2a652aceb357ac151a2219fd08c5104d23ce70e4b7fd,python,90,42,48,58
NB_faeaf0bdd561c2f72e564a0992327bf0b5f94f50b1cf0fa2d826f3cc7c983089,python,11,5,6,33
NB_b1f3f3b8a98ed10cd14649a77031e4640d6fa9b36a276bf63408263767f8a8d8,python,34,31,3,3
NB_05ddee656fb057f1d5b873859e4f9e1d060ab608155d1b1be63c6a635c683fdb,python,23,9,14,52
NB_9c4b451dc1a35bbddfef62207bfb0d21d6ae76c5a326d977a929e9360f81c962,python,13,7,6,51
NB_71580ce771d525322900e724f280f81590b05ced37bf4f282ee7db61114c14e8,python,22,10,12,212
NB_8e3bafb75df4a391692ca347d1d96214db1ad36e524c33f0de008d3280d54c06,python,16,10,6,6
NB_27711c96726bde9cca5ff65dcff367e00a933743131327b3bffc366361a0a7cf,python,15,10,5,66
NB_61e9f5c9ef19373b2f8e1379496cace3c7e34f3c48fe7bb46e4ab29ca83bea80,python,1,1,0,0
NB_d9e6a28ea93ac3de77d08aa1a58435653a4b135a22208804f7cac409fa066674,python,6,6,0,0
NB_29595e166949450b5e740b23a8577ed29dc249cda47290cd0794fcd09fc2ed62,python,19,19,0,0
NB_e1fc444065fd8c3223ef8617dac61b5cc39048f1554950e80ebb41939db13836,python,1,1,0,0
NB_f6b9c75dcbbe6e48892288683aed29d779aaa6914f40d368c3257319fe319465,python,11,6,5,7
NB_c190f77c1766e8078d111a45ab81cb60ceb7ecb8b8e55c132e7611979c3cfcf3,others,70,50,20,31
NB_708167eb8bc89536201cf179d12334dcc3f855331db3957131128b3b3481a1c9,others,54,44,10,10
NB_15b7dbdd1137d6f8b8a2aa1aec043d6a4c05d636ae0814c3f381837af0082a5d,python,46,19,27,27
NB_8028e8ae670bb59ba91cddb0d9e6382a12c9e5b208e4d7943d89614a4532ea2e,others,61,59,2,2
NB_45f84a88b779a1ae30d8f51be77ea3f74bd268fd0eed64c469d8fca26b7d6401,python,23,13,10,69
NB_767546017ee21a4b7cfdb5e2a156307a43e72d6037668ce22904ca4b1dee5653,others,39,17,22,22
NB_58c1a9efe42d43f2b42e8095490f5714eaab990f1b3faebca26286eb3752c351,python,2,1,1,1
NB_081eeb5ad7e8bf5c8271047d613eff8cc507f9a193f04142793c38036865e011,python,30,17,13,57
NB_77a8057624ca129facebba9680989079e8e95be566db04776c02b1e7fbc66c20,python,21,21,0,0
NB_aff297223dcef3e0b5498655ccff07f9d2ac1817624a14953e23a776409e7db7,python,12,11,1,1
NB_6aea8d3a703582b1f77b4b44d277dde5cf986f76cdf19261edb9b335bfc99025,python,37,18,19,19
NB_0f90bd6128b0681045b16be05332a2f23b6fc7aa45afb605fb9d3121aa3c5738,python,15,15,0,0
NB_4abc83f1092a74ed2b0cec39fa26c58bc4ab9c609da50a73166731697a84d49e,python,52,42,10,26
NB_a5a0505d9d7b4a9449c2e9a95d6c25b3109f33a16daf0dc4a26651f8f4a73605,python,42,22,20,35
NB_ca58c4d6c2012708c1aa0c173a562905e2ed0856cb60d13c4f2eb5d0993058ac,python,71,48,23,51
NB_1c771ab4bce04e1d6d36ac60340865b724b1f4b1f0f33672a8853f3c6d37c79a,python,16,9,7,30
NB_2fdcd99617b0a5d3ae6d5361abdf5c5dfee623a3f8b42564a4e8d4664a56b0cb,python,9,7,2,22
NB_c6aa1054436c70563f0a35e16594552522000d5550d9846671240492bbe3b398,python,3,3,0,0
NB_489faf86f77382383569f7b36e3e25c957e32487b2129329ae9043805c55a7ae,others,34,19,15,28
NB_4dc7b421108d2aa126dc8a6ca26f8815b38513ef07c80245cafc0d537cfe80cb,python,32,22,10,296
NB_b70e12c7078bc65ae2fd2d5894a1512042936596f7e0fe88a5db52aed73dcedd,python,10,5,5,7
NB_5577307ef497d546fa06c58461e494fa3cce4acb1f2c3f486f08a86cfa3f27b8,python,15,9,6,28
NB_fba38311c68949a09cc45cb1106ad6458bf1fde12571b14ae804133b444c4bfc,python,21,19,2,2
NB_1be2da00075f180bf5100d86221aff1bacc9c9441a13f2a58fce05c9851205f9,python,4,4,0,0
NB_b151e53736940539419f7be8e506838b018541917477f06bae1ee94f1061eb17,python,25,24,1,1
NB_c767826745de04e7f168eeac4c98a9494e0dc0c8c7d3f51d4e7cac7a5ac2e3e9,others,94,55,39,44
NB_307a2dd9508b9d24b3205bddcefd70c4653f3053708d311ca5305dfbb0cea894,others,28,26,2,2
NB_e9850c00c42df1ceb94bd6eadf5c168cb178b0fba4e2584ae8ea8158737f6287,python,60,55,5,25
NB_39a514841f0bd342b1586dbf3092f1f60ae23f7457a3e10c740f7cfacba3d6c7,python,31,13,18,38
NB_e5c83c4c8a6db3b5070a39cfcbebca91261afbb5bc86dd6064155ca0771c3691,python,80,51,29,37
NB_6b29782443119d982b697ecc5fe30441b812a3b521e7561aedb5fe49214fb925,python,38,34,4,4
NB_3378aac573ecd3d23c463184206726cf44b51dbe531c8126ca6cccd941b9fc13,python,53,43,10,13
NB_c017dfc4403bbc00ceb467a163e504c345ef30caf35daf26a12d28d53035ca5e,python,35,18,17,38
NB_15da77227ca544beaf586caf545f0716c6225121a1e473fe446a63d9c67a73a9,others,27,22,5,5
NB_58c5e0de0deb44123c5a966457c1bcf2e9160a6aebabcc629cbc9894c5beee3e,python,20,10,10,9268
NB_50b0ef7f26ea5f0de525780123a707c1586a6e39be69030d1461638292b35be8,others,40,19,21,75
NB_2be7595beecec9f4515553f6525cb1cdd51658012dd5c55660bc2952e0c09ffb,python,21,10,11,112
NB_0741ab62a3fe1f4ece278d51fe03c31c72098de8ed4379ac27b2190f4dcbf641,python,114,65,49,155
NB_9d73ab0e2a5d09fa87ebbf4d84c2aedbd9a1d2000de5260f445f4eb943754a56,python,10,6,4,4
NB_a2e3c78e69cd0af95f95e260b1d7bb01772ab916775b1005b341e851de05e949,python,33,33,0,0
NB_59e4dea17b9ef0c8517ec0917bcf913ff9aaebdefb132da600d119b8802e0a6a,python,196,160,36,36
NB_f480e525ffb72ceb803b03b233a5df57d5b3fa44b981b2e9f14fc5ca97a8239d,python,87,54,33,95
NB_06bcd426c57820e59bfd02d8b032124bf8d8a5d5d8cebfbe57b251e985bbb037,python,49,26,23,293
NB_83166fd4da3f3d74202621a25b7c059654ec40736f36f2164f2505c0fc3311a1,python,2,1,1,36
NB_75cc54b1c96249b1a2ccb7104fb3da3c26d846c5758207b7176ff5f38fbde401,python,13,5,8,186
NB_5cda4911ac181fa194c7d9ca6914313d839e74dcd5a872e2e1941ab676a2dc5a,others,0,0,0,0
NB_e4742e0a726dacc2be39a63d5299b8bf7bba1ef8ce794e999004885dfd281850,python,32,16,16,159
NB_df7cf81b06c3f8fbcab147e6549924d42122510ad6ea76f1140e7b44ac57a8cb,python,5,5,0,0
NB_acfc7be7e5702a52253ccbf23cf5d794c95a1f4ce3edf35ab67859d1039e9478,python,14,9,5,9
NB_338b66c5c2240a79c3c91447af47e19cbe6c3d12071c54d9160451a75ac4be98,python,66,45,21,69
NB_d27ff2b466033b929dd5af57c92cea73f0678850c1f829ac77a1f611c312ffeb,python,58,37,21,81
NB_0e690547ce73697428dec182adfc0c09e1842d672119f2944bed38da29006c06,python,18,18,0,0
NB_a5385b8b5ddd1564d91b85fa24df385047ff6a710e545578355367f18fdc452b,python,49,28,21,23
NB_b875642addba501bf521b28dfc04013dc579a91a2c65344c965f1117eb09b4e0,python,12,7,5,5
NB_05f33cbe63b7eb2ece0b036da6bd6e1975803a7aca63d0fe271c3400a54fac28,python,12,6,6,98
NB_819e85a64b2428445d302f9de4c0a7220a88079f31107fb0a852296e32f86440,python,3,3,0,0
NB_66ed4937502528805bbb2746510e83ff0c164904f0087eb3a764dce25e87ae5e,python,26,16,10,46
NB_3c1fd387121990f20855d97d85bac0bd2489a428a16b4634cdf84b6dfbd89512,python,5,5,0,0
NB_64301355ca8a61a9c72f2481baa9200cfe3e4a2f1d0355048ea917ef1976f70b,python,253,204,49,62
NB_2772935277d4684991c018586f670365d2b919018573be9d488fe88574f10199,python,3,3,0,0
NB_dfef20fbaad135ac5f73964f5986ab855b38a957c29f492e3a0443bf5c4326eb,python,7,7,0,0
NB_9d624fc7cf7779f3ad3075927c4fa203331bc2dec3103d5980949ef6555f1ae8,python,117,85,32,483
NB_f937f437ee33f51a23ea88aeac02ff46de556122eb0406b725af2547bb07ed96,python,2,2,0,0
NB_98303de35cd55ed282da18a5989c45dbd1cfe17a221b5c4711c5c28fef917505,python,17,8,9,11
NB_ce0082d3efde4206c84e7038c3612634c953ca8566938cd67cf5b659dfbb0977,python,24,13,11,37
NB_6956bff8fdca8817c39acd03981d09e96563bdc439c4a91d3d9e1c8222ee9bfb,python,36,36,0,0
NB_5dbb431596ba79a0b492d9c9d55d657c4f4e0f04865309e04f6ca54d12be888c,others,21,21,0,0
NB_1129f76b6fdd7d6e3aaf8538cb3515ad0945cc709cf6fe8e2e6d14347711e593,python,8,4,4,8
NB_c47a050c76808d294f40dbc0ec63cace25864a46a7920366db3f6ea5ed8e2df4,python,12,6,6,24
NB_2c84ed96881b58555bc73d3d7354bba2480892e3c5d5fb856815019c18f10e0c,python,13,7,6,6
NB_51767067b9b695e23cc06f4f7fb3739dcce355e4514d4620bc2786246a9aa42d,python,12,11,1,1
NB_2b2696d4c51751246ee2cd39dc1bbe518ee152b58ce1fda08ab324a6b6617afa,python,8,8,0,0
NB_46b50fcbc8ddb55d0ffc37fc323a79d7948911b73f073f413f8d47529038bb18,python,20,12,8,16
NB_e164dc0ee6ba380ce71b74d48a4038963c4c11b62801054d1eba10a914298520,python,32,18,14,14
NB_1810026de3914d016ef8411fd00cd80e5d7dd8ac9287615f06521fdba23a63b0,python,56,56,0,0
NB_01e9c598d7d1f2c2f2258bf2342fefacd6c579bf22034007c66a9ef28934755c,python,10,4,6,139
NB_1b7d3e1e72a26ca04bf830ae2f9f4000b6c32fe0941fe44edd300f8decfd85a9,python,9,8,1,1
NB_275a3c0f3a6d14ccec2c4f6f2c615f5f263279707c4bb526bb6813f3356ab690,python,4,3,1,1
NB_c155d931d271eda500beafb47306753e4dacd11730c0ce7cb5bb64fee2d9e59f,python,37,13,24,294
NB_7742b9274071118482262fad3da2cd00ecb731519a31b191e3c4318329d68605,python,8,8,0,0
NB_325bc1f94cf5636450899a35e70fd6f7b7d2b5b428989f18fed4f51a2073be5b,python,55,51,4,4
NB_291f67246844439615ab693a01cece341a13b301181cd6e5eae373b9edbae51d,python,50,46,4,12
NB_ccf51877e43ed16fceea4d1455e66a3581e07cec31779b416b8cc3161950d618,python,12,12,0,0
NB_c3c34bb048711962cc05e497c7119617abcf1faa0f4bd9a43b0f453421379001,python,20,15,5,5
NB_33b656f0f08c03ee21db9c9f09ae5bddae26a34dc305af0f25c0218db94ab5d8,python,41,36,5,5
NB_caf2dcb079f6cdccb9c8d55a62df047c9f943cee285809be8c45fd96e8d97bb1,python,51,49,2,5
NB_a444815474a1bd1b0ac9c39ea612211de0cd8b15c7b12088184123d8e437c37d,python,34,14,20,49
NB_1639342485b59ab80f5a832a6360bcf4f1b8941220b987fe03d611e7dfdd3c57,python,31,14,17,212
NB_953dad939d666798ede17b08f8d757f12ae0ed1eed3ad55629443469c75717d3,python,11,6,5,5
NB_35757d5a2e32e0504173da0a95b75cfee616eba06f8f6db6da8c9355df501fd6,python,25,11,14,40
NB_7f8076f83fb312914199cd3ebb01b7357db2f2962908c24cf366e9be4b71bed7,python,59,33,26,37
NB_55f108981448614c46d5dbdc8bc4525a0a3ca44731d38cae4a4be8c47ae1cd8c,python,44,33,11,11
NB_64b3788afb258d41ac226937cfa9f90333d09bcd0d88beeb42680d28cf0d943a,python,29,17,12,12
NB_e6a684ccfb3fc47d6d284c173df310919b3acdf9892081f17e36d4451d1ad105,python,41,22,19,120
NB_b8c239f7ff620f8cfe4172270426232370ae777023b93e0c3777065f13428ecc,python,24,24,0,0
NB_1e02d2a73a53bfde92f737f331723326530e4f78c729957ca6d9ab63a0cfe79e,python,16,12,4,6
NB_107c308f275e151724b3716575278ad642f5d669e10e55c182fca09a14dd9b09,others,49,42,7,15
NB_96e45f1e56bfe66011710f40bcb40de7faec2d21fea16dbf7d0d0d54bfb976e4,python,36,30,6,19
NB_a7bcb41e8edc0756217a60a9899e15a6fab32d20843ceabd961b7b070d44964d,python,56,52,4,4
NB_9e3b0624705eb2229ded278db4a16ba831412077485f56ee8e5629a6c5293470,python,41,22,19,120
NB_3c89438118cc06f32dba6badfea7e6b05733df0fd3803848cae1dfab6cc0aca1,python,575,288,287,287
NB_1621d32e2e2b81fb207a3dc269604428718bdcc35b9ba9f324e85c49854143ff,python,16,16,0,0
NB_e9487188a7b18f2c65eef5b1286178683099ae18d07c2782089f82a60381f15e,python,5,2,3,25
NB_3d8fcf3e2f4417528e2e88790ac97838a753c005cce1a3d6d9e20010a9cd270b,python,150,142,8,29
NB_c16f5eef74dbbbb15ca581df2831612993591c1ea4aed96728cc50dfffcf686d,python,25,1,24,62
NB_20ca8b97922013a0bb8aa3c9ecd4e3a7c9854e53e3b63f9ca0046982c1037c7a,python,13,13,0,0
NB_b36aabc7ff26adb52b75f00b8da5321ccca19cf1a72cdcefa91bd4acfb1fcc50,others,0,0,0,0
NB_268f5378d7cc1086f98f9632cdbcde2157246dd782feaf596dbe2f65cfe2db79,python,79,59,20,20
NB_93844bd680c1954a3c2f9c756857f48fb42798396279ca1697f03f3b60d19667,others,118,109,9,10
NB_57fef20bdf8dc7fb4ab707816200be4e77adf4986253360768e1859260eb26f1,python,15,8,7,8
NB_ec3031ef31daa174fcc1cc1132baa13d8c9222ffd6bb029c9e445e84977f0dfc,python,50,40,10,14
NB_7502bc75a9832037f45d0464440af9ca2422bd47faa12f08094cfdde59476414,python,6,6,0,0
NB_26a86c62dbc798128d116240210a7b62ac3cb4084122f53edde0fb0ae03a73b2,python,44,24,20,36
NB_79277ca21e09ce521783dbecde27b43afc2c9e2ee25c1bcea9233d5b98c3366d,python,28,17,11,14
NB_ad1a88c419d6394f7bcb82ce644e098a9c317d246f403fa75b5226d3cd68fa2e,python,10,10,0,0
NB_f7482379570db1a4e6e51662b8df3c8ed084835ab32a0b6f5ee3303ae15e4431,python,7,7,0,0
NB_8e927648d61dd961fefa86377ee09e15b61387bb544972206cc1a9a7638209d6,python,33,19,14,165
NB_603365be2fefaf2612be05577608494f8f37535f0cd4a547aab1cea724e3f210,python,3,2,1,31
NB_d816801516b1b009bf241a56a47551157149f7eaedd3560bf879a99294e13c91,python,71,45,26,52
NB_f429ee83cef1ab9ae5e58f25d1c61067cc9fe39458817a9747e683c075032dcd,python,9,9,0,0
NB_f018e9918ac01a7bc21f6208521d0b6b9d4aa298ab538ee7b54665a81082c9d7,R,34,16,18,62
NB_3aa8b684a5ada14e49cac19737e8d4984e1483984e81f791f17bf88dcdab340d,python,11,9,2,2
NB_89a7bdbc2e321756f75488e05ef7191d3408a4026ab307096afeac1acb269468,others,44,29,15,21
NB_bb2fef6ca2750389f6d2e40bb0f8dfc5198e8f3545730b07b978ebc7215d9f24,others,21,11,10,10
NB_cc40479a0971a10e92becd72e1015bb1bf0684b4d2647e04b55ed03a3d9ea94c,python,6,6,0,0
NB_c68bdce06196d5be44c1063ae64d2a92cd84f868fc9c9fcad99a97f373e21380,python,12,6,6,6
NB_6a3afee337fab6ddb3869918e0481a400e3673a8bebd3079af431992b4b38d7e,python,7,7,0,0
NB_89c310aeb215833687adb2328667d59bfafde268f62f0ec965fdb54ce92dabf0,python,2,2,0,0
NB_abb874fe3ba5ad47493de3892259e8ec41b9e8e6712b8cec0786a23517fcd346,python,10,4,6,17
NB_e80e52478cafa0a4b0cb56b8808707f0c07d98b152eb5b0b1172c16eb83cacbe,python,68,31,37,76
NB_afbb4a904baca27382eb41f3db7b6d92f7dd88f10868726236696ea9323bfeb7,python,21,16,5,5
NB_5dde9f4eb8e0704dbcc774fa77c89dafb4a35a2cc4c4a0b3d9d11d55b73781f6,python,17,17,0,0
NB_410fd3035b7c46299123a4cfb9ce5cfd4ae04961fb12afa836deeefe2ca8c73c,python,19,19,0,0
NB_0324029dd0eb3ab0e9c86b629532e05965045a5f69fe3238b2a6e4b710936d5c,python,60,31,29,81
NB_235acf993b962c3fac4b69bdf9cf043d93d0f41b67afcc319b7f0169af9a3965,python,8,7,1,1
NB_28f31e5a3d7e1abe26da5d3ce12c96743691ee99bacabd694fc4bf6720bb9372,python,16,7,9,124
NB_2a35392c41a6b3a68d23faf35a961765b386d88a9d214c99f24e6956a610dcda,others,2,2,0,0
NB_3853a33b7f8d65915f6ff4a3ed74b8d645447c5a6dbe6bf7cbeb33f1018bda2c,python,19,16,3,3
NB_b49b44662c3bbe4242439becfe886700305bfa2168aefe777179a0101bc2dc34,python,38,33,5,5
NB_ad5ee99e6da8b34b86c87b7ba75c046b5ced13a38e5078bbcac6228afe8ffd06,python,6,5,1,1
NB_ad631d970d429cde8ab182f61a38a5abf7844fbdf763fd55151a5d1f6b5ae84b,python,3,2,1,1
NB_ffd58b50807b4506a2cb1914490c5caaa9f708987d3a5ed037c9afefc161e5b8,python,12,12,0,0
NB_998c37e6a49791984a5164e5af1e3d1d9b1885f982afec23e81041b949bfe96f,python,11,7,4,4
NB_13d04d07134b5904a0902d425e6e28a29c66a688e639e930097dafc41603f6e3,python,10,9,1,2
NB_2e1cf94d6a6128d73367a3d83aa827fa1c0e11582478b2b6184ec72b0863c515,python,87,47,40,51
NB_73fafa6e53f09955a9b9fc958d789aaded34c5d7868602a6f4e75c49fe880797,python,3,3,0,0
NB_430913a0048c210a910e07e7b3f990d117bca040d61b04868b210a5db9a71dd5,python,46,25,21,273
NB_aa480589ea76ffc7a8780eb9c2651890745965d3682802e4b237bc12a47a70e1,R,36,26,10,12
NB_b723d09b9c8918b8218987d0d7dbbe037ec3a5dccfe7b50c7f038fc644cd5662,python,4,4,0,0
NB_ad986f76026c65a2bc8dea001f61492914a96959d9548116c8a5feb3f6e3ccb7,python,19,14,5,6
NB_c4ff2e73fb7d50b624bcafd3ecd38476d81c75c4a0193c602d35dc2d59d96274,others,18,14,4,4
NB_a2a9e7ecccd4cefb0a321b1f83f5ba6f6e0bd28732694cfc2c9f9624393bb613,python,24,21,3,3
NB_604bb188df5e56f622be31baa0229bf7a73a8380076ac8a78920ab3674bef0e0,python,6,6,0,0
NB_781f4a0df222401f934c0acdaf31b32bd96355666447ce1542291ab1127ed0b0,others,9,9,0,0
NB_7a9ca93386fa03adc17270c909953e5742e364c549b8a9a407352fb490fbc46b,python,57,40,17,23
NB_42dbc306809d01f9e47e2c60051b089955d0e9b0c7b6176dc6158b40e7121cf7,python,20,20,0,0
NB_87c2459bd447ca1ef613a2828aea9efb809d38415785e20d25007e6630a72a22,python,51,40,11,22
NB_6e312015e726ad5b0a2eb07d42abd7b8c0b4222b020cf3bd5adec31ac926b311,python,28,16,12,108
NB_be13e37190242912a684a46bf7e6dd4a27d73778fb696847f37a9f4c5902eac6,python,31,17,14,104
NB_66b84ec768d59e719c82d081e59955818ac6ac4a62e22ddadef9564360ca21c5,python,23,12,11,13
NB_117bb54e77c56f84b70b0ff7fffc77c4f911229189457a2eff1da9c4ae402595,python,4,2,2,13
NB_aa7463d5e4b9a1ff406694e43ae2ea71f2adfab8fa46d08c9e2acc3d32afa402,python,33,16,17,106
NB_5e5c6f33c15b1aa67ac682b1068f797cbd6020f123f4fb3da078546059a82fda,python,26,18,8,8
NB_7fe87476d07f80026e6e059216f3a625973d20bc6ecd29dea8cf01274f8b1c23,python,17,6,11,29
NB_5c4534325bd70166e59b9e1bf635072025e4ef836479522809c283869a8c9917,python,116,72,44,303
NB_aa3d81eff16a61f500d51b71f70cd3c10eb3cc3e9aafb02d91156657e12b42c2,python,23,16,7,9
NB_f36d228fa232b1702e56644290dc565f9def47fa6ee5ca8555321bf3f0c05df9,python,6,5,1,1
NB_a899354727ec2fdf5c19bff2385fec73453bf7ceca6c0f491343887fe10165a7,python,76,46,30,46
NB_02c4f2d1ec8e265e89d21420bc4207faf63de47f892418cc2ea10efbc4843b59,python,53,40,13,15
NB_49987b4df5e99f37189b2159fec08fca7a1f6045ed7ff654133a7961650ea9cd,python,30,14,16,235
NB_c3649f8a9c1918ad2f906cd820b13eb71c88dc786836fe3f0bbe075d891f522f,python,10,7,3,3
NB_0b6a4e1282b37e63e68508051e5d06f556e86e0aca4994d699588afce0e1f4cf,python,38,21,17,42
NB_cc07eb76d3b77b1d6888de52e33a1a560939956d6db4134fbd436a761cbe2e45,python,16,8,8,15
NB_fe5b91cf708c7f263e1fb7f58e9667e80b487713cafdfec41a5b7543ed18452b,python,27,27,0,0
NB_b34f62a0aefde9ab7cbe6fd30004538b3ac82beca9c290133c9020f5b75ae591,python,3,3,0,0
NB_892b487ff80bb7ebb4c864d9cd58f5682433f3cdfe1a147d505a01d8319d2a4f,others,7,7,0,0
NB_175147def5323deb37d746344a06bfc3f4766b00ebc05afa69fa73764d6a7724,python,28,27,1,1
NB_a10570f7ac5a189853c2d556cd70e1561cb359ddf97a5efc08caceb98ca060e7,others,11,4,7,148
NB_81e9ed616c2bd1eabe87b39952030b15d5ad12e89725b9819ecfd72a00bc7822,python,5,5,0,0
NB_d4a84fa20c0fd800750668b27fe6856253d213abbfa1a3a214797ad8a3a4063f,python,45,18,27,82
NB_e3e73df0fffa464be8091e93a4c2d049609d28f7d41ab8f549a8ef7e537d4a07,python,4,4,0,0
NB_99f584e5c02fc68b037d6a50f0fb3fac3fccc642264a4c1f77fc094cb196d4ce,python,2,2,0,0
NB_25cefa2808d5283e175adb6a39bee09f4d1623f51649e40d490b95c2ab68f670,python,38,38,0,0
NB_e383c2463989c9780f4e98a246ba9e67acd64f6285f44cc52a3c3b43ae73c0ad,python,27,13,14,59
NB_0c81d84f1859a33c39c725778dda57e1c19bcd9ac667df6964f4eb5e8f33c495,python,52,37,15,18
NB_773bb867618965ce4bfa2fcdcce117b4d7c55e853c3e6cec5866ea7558d14e99,python,59,15,44,318
NB_9c3ad9a64aca5b00c4188eb262e84fc84d3855c8425433905952d362608c8482,python,11,10,1,3
NB_75afab2d7511f6d2bd30a4b237749c8ecea590b289f15d49b2e26f72aa1f19da,others,121,112,9,10
NB_d8f27bfd95fff578b1f0c02c1a81153dec7a6d3b4d88f1bff3b72add2f9a90b4,python,11,11,0,0
NB_cef698bf7d3da779d5810d4267ba79ddb290002ac783dc87f6b90c6c103bb701,python,48,33,15,15
NB_e212c36b23735e2f98d7d7233dfb1a9cc91a2db7801331da3bae9d697c4c0a79,python,5,3,2,15
NB_6867d2cfcb6e914b612a83ab79aca07cdedf93d9854f88135a449abb3d728a94,python,10,10,0,0
NB_952c4df26b45025573bbe5f060b8e30e5c1cd12b301757b4f0ebeed2d0e3cdfa,python,12,12,0,0
NB_068fc649e7921d73fb119c0bd5b038420a52278b2fe115694728340538fda9f9,python,3,1,2,108
NB_c6db0c7c9f28c073ba24effcc673ef3736b13f507202bf37ae61f95e153b85c5,python,19,15,4,18
NB_b7825ca090c1993624f1fd457b50f2288a0a1ab297ff0878b621ce823ee2093b,python,1,1,0,0
NB_da7a4b2d73b52f4cd88a75af88623cdd4a467e685a9f283f8bac28f7e2aaeca9,python,50,21,29,186
NB_cc46751873df776562d7fe5debdec661fb07b057e8e91a51b9e6bc38e824e737,python,9,9,0,0
NB_1e6724cd7fc5cee357935d7d0aa597656f4f2abb1572266fc6c3d3a37358ad86,python,25,12,13,59
NB_b3089ad857fc6587622f6134c5ea8c56c5e35d7f63889903eec46efea83705f5,python,12,12,0,0
NB_76b8ff4a60c2b14012032787f3954c5324d03c30b0a791a9ea91b6738510f457,python,108,108,0,0
NB_50d36a3f3f234f825f4a76f4d19060f5da78dc143f4e450655cd149f8f7a7c63,python,8,8,0,0
NB_d0da4327042f08d86d4681442387f0523e93446b9a18cf174a4756a77fbff1d7,python,14,14,0,0
NB_4ac21a5b14d5a32beefaa9add0e2b7e81135bbe5726f3c610737c4904b195c48,python,27,13,14,59
NB_5c60e5ea884e60219d97952e6941c33618c6c296f9301c4b381aaf5334da43e6,python,3,2,1,5
NB_316d156ad6d845daeb6464c88fa560130fa9b0ee8210e8e9e1e957eda96a1600,python,9,7,2,2
NB_e7d5e192389cc00fe3f3c13c15737be4ee700f7e8d0d19add00a3956c380f6a3,python,20,20,0,0
NB_48761f8ba02162987a742c064b8787056dc8430c8912794c2d5018cd831f5c5a,python,13,6,7,7
NB_e4c7edbc37da477cf7d9c18e9e5b08ad3fa4e28da0597daf384a506ee7011bcb,python,52,39,13,41
NB_c1d4a7e711a399dba99ee42c92eb1b6af94666d662f5012fbffb1c02ee6b6690,python,6,6,0,0
NB_8a8f7e2aad2dc3ebcc334b2befbd026b0c393be5e48224058b04f9bcf8301d0a,python,13,9,4,4
NB_c4253c07f7e06376d3c614b9ae7951a4758fb63e64cb4c1859aa4b47cf44cede,others,94,55,39,44
NB_a4b118af38054f1841b8ee872528c3267c6a034525232289a62e27784931ec6a,python,62,41,21,29
NB_2a885abb9af40be4d2db5684a6185fba90eaf52d0f2c9c9bb4be3dd7261c4731,python,12,6,6,33
NB_b52ef9f06405533c3c52a5396df3264f39914b6e02306e1d27472e02aaa0a0ef,python,26,14,12,69
NB_c2e835c2f0186dbb1339430206d493c329f0e1c76c9cfc6cdc0cebb5a764c729,python,15,15,0,0
NB_2fe8948024756cabd39055d3181a9768dc1170938c25398880d58091e7c86f76,python,60,60,0,0
NB_aee3e3706c96379a5acf45bb7a604dea1fd32dae83d594a67f510f0628839d43,python,70,62,8,35
NB_0cb1a6a0e7b1032de92d6c51146425cec6c65519d5ff5374d912f6b6a3527243,others,23,21,2,2
NB_709d43223a809b932db66240ad264f21bd7b71f57480b6243f0a683ba8b05a77,python,8,8,0,0
NB_2cb8e7dd75f84b207d20cf26f63f2a40f494baed34d46ed63577615d06b3bb1f,python,39,28,11,15
NB_e58efb51d613bd2d3d30378b2a3cc68e7b18e5e17fe11cc7f146aa2dfb8b482b,python,78,65,13,13
NB_48695757d51a20c49bd5c17cee31564e9ce123e7de82e3ceba2e3481a20ee83e,python,8,7,1,5
NB_1825ee92757a509da932c8045c317d1ad8cd3eed4f573b52b5497ad052c03979,python,7,7,0,0
NB_9849a03d9e763acaf50e6c9752991906c420fe883a9cba04403b439a0fc3bdca,python,26,15,11,33
NB_bf8716686697b792430345446e40203f6df3d6b5dc77d1981b2fad59f152be49,python,69,29,40,287
NB_7d4f5235bfd1f799872bbef8b70e87e85c3e30ee79ab7984389bf0a2daccd3d1,python,37,33,4,7
NB_39148f4321352b51bf43f0feeb1199f9b1fec1ce3d43267d807a22b2236e7ab5,others,68,58,10,58
NB_b782ce0993f5c49ab4e875fd7085764e5a4d89d4078c06512d6067cd4e5127e5,python,43,21,22,109
NB_e9931ec04f45c8c0cb463988d3d987f9888af87638ec47c59f90ff9f9a7762ba,python,24,19,5,5
NB_5ebf44561ac25f644f82f477c81eb39b7ba9d1bc1f032dec08e6221c1aebc8f6,python,30,28,2,2
NB_2bbd768ff253628c8c4422b33b06076c92b6f4a28ce9783875778926e380334c,python,6,0,6,116
NB_cc0ad2c558b7d7aed81cdf5712591e98339cea1f0e3db8fb0ccc2800bc5fbe21,python,12,12,0,0
NB_c2f7d01d922b917f0cac0500bb8cacc78304b9b7aec0b481dfff2dc814b46a31,python,21,14,7,53
NB_8a6228974cbb61d734c0f63f161ebe8385b8d9306a546486c4d1ec0c0859af75,python,12,11,1,1
NB_b880c17ddb7db5f7d5c9e684cce55801b2cea7b3792ed80b8141ba121d2ac6b6,python,12,12,0,0
NB_cf17629c04b8ebb11d742cc2172304b6e9d34bcdced5d644541f4b22bccd8979,python,12,7,5,47
NB_fb4931c51d49133e300653eb2316c52e6af5f8a4f869ef3ce6d8e649890e2355,R,15,6,9,10
NB_391e4e62d20771e7b000bfc988d55c01ef1d92f64ff183d3411c9ed844883b27,python,42,30,12,14
NB_3a33c54da3a8de8580e35c4310927c429592261aa43296a344604f2a09adf83e,others,0,0,0,0
NB_19fc1b49279f947450bdc9d676352c1164de925020167dc0d4bae458f5edd017,python,42,25,17,20
NB_9ef4fb11f8b95b21aa3f0bb1418830438b12961478ff221832bb7317df7f72b7,julia,47,38,9,10
NB_bbbc55f7fde486559bef30eb0dc4d9444fc6847fbeb02500f74784edda95efeb,python,7,7,0,0
NB_d19127bb7a93a9f51243f961b7d0efcbe43a896f9e5ff7e917f6a94c3999a758,python,17,11,6,8
NB_406667f14557174d5cf07226feb122c8aec5cd2fee6c968659dede37637cf0dd,python,13,7,6,31
NB_89a19594f6d970b9cd40b0eabc64ea2b6ab61cf3aece0483e0844a4dff28171a,python,21,3,18,178
NB_312c3f24350dc6534a61cba168bb5c5ba6f2555efcb0ea75f7890e8202599da6,python,12,12,0,0
NB_fc1ca6a74f9bda1ed57cbeb5a4499fee6d4a4cda09087edcb0f054d16cd45f70,python,18,11,7,9
NB_fff9000020d470775e46e4339507834c5ab00be1c81de56f140303f60c643a66,python,52,24,28,158
NB_68730e9eab8f53a24f73e8492de1567f5a482f0e2b9062b940d44614b79454ef,python,35,26,9,10
NB_192bf6b686947a357b13e8d24345cbadf02dbcd001e1cc31f3af4b3cd093d2dd,python,87,67,20,28
NB_da89f540cc42ef6f4efa0ca971869fd05b5e05f23d09f731606068df629bef63,python,10,9,1,1
NB_06b646747bf2307f187dd871bbdf7787a95a3e8d0f824545e512fa42e7f4ba46,python,31,22,9,9
NB_e4b789717ca875bc34406e54b2714bd746ba14f197c8d1d31a32babf3fcd7ce8,python,36,17,19,153
NB_318180f97c666f9bf22cf6d157deafcfce6ce4680ebb59b51b398040d34a0980,others,54,24,30,149
NB_4dfc8da22ec278cdb0d177272704012b5cc292817aaa0311c3d7b13cc6279106,python,11,9,2,2
NB_77ba73191f865cfbce8fde8880e452ec4fc713c2d21f0fe9b7793a844f56b135,python,38,34,4,4
NB_5d5d563fdc0b206100341b5169c206ed18bcae7c1cfaf7d921ca3ecfc29f550f,python,5,5,0,0
NB_1df26397ceb45cce636d2e1f6bb1f05daee48106e07e04e2f92258bb02fa194c,python,19,8,11,81
NB_0e2c4638e7b1517b0926767556555cde873dd7db2a80ee7ccd504f3de4a76485,python,18,9,9,14
NB_482f624ec0c9b5579651f6c858dda664b08cc985e3d536ae4c8385cb1e32366d,python,8,8,0,0
NB_536d9e1f1c5868eb96848df2500f05c573053f8b30a11dbc66b321e52e43f07c,python,40,26,14,75
NB_7217e22be38cc136d7d359d8628ae5455209ef1622ae66abb9fc9d60203743be,python,168,153,15,15
NB_5c6670a151897e58f29c0204721c44d4cbc1925ff997e7c4c758303dc67a3860,python,37,32,5,5
NB_557ef9f6abbfa39b6cfaf4957afb3a00358ae7d27a5d5637529dd558a681ef55,python,51,22,29,131
NB_ebcec2a943a291d3614f87ffbb086ce97fdc2cb80375e322ca44f79adeb050af,python,11,9,2,2
NB_2216d92eea1df3363117f0d011e686bb80b6e1ef32c308442c971a5b1b9cdd9d,python,2,2,0,0
NB_4e1fc2b4a95798382403d2a9806a577af433ea84c51c3d31b9e24a60041a0680,python,10,10,0,0
NB_bc28ccc8e23300a527775ac371a35d8be2a999dc4235a0541c8cc69a1dcf3367,python,30,18,12,115
NB_153e1a118c3718fe09ff31243c51f78e8400884aaacaafbe874d81b0f0d28711,python,38,19,19,118
NB_1179b7a0f8326f4f5b677b6b2afba10a8fb6de592c25cdfb5782a955a2dfe34d,others,75,42,33,39
NB_b4dcb6fbd6674614e9f3c6adf245624f58b02a50e541be5897682fc5f813f646,python,18,10,8,31
NB_b319426e94636a112d2ea13e2d274c33e3a5ff9d41c21060c7f5bd932d446021,python,45,27,18,35
NB_52cee72420a026290816f6cc50293822411b4ec37cad5ca519e34a3aa0adc513,python,5,2,3,5
NB_c49f020d5b0c3ee94deee32b0d66832a70ca80dbf9103bf1c343dff78b9389aa,python,28,23,5,5
NB_e89645b6d25982632e675eea4998c875b3e2da1f096cc4bb0e93c8b673abc2a5,python,7,7,0,0
NB_bfde415581b34cbdc5fad98ec0b4d1c114096f74daefd1caccf67c0ccb6451a6,python,4,4,0,0
NB_50a8ef2a736d7f18b0095ed7fab42d0259ddc706aa05110d7404f5db55145321,python,21,11,10,20
NB_65eac4c95f32d673acace8f86ff1c8be932ec00332691e85119532206f9ac41c,others,17,16,1,1
NB_39dd30a2dadbcc1871adb92802411cb3016bed700c803ab1a3d5544a186533dc,python,117,74,43,64
NB_8aaf92e1e109214ae0358a845f5570f8227ec8c56718caf05095e99ef2a3bea4,python,2,2,0,0
NB_de12a68ee5e723021dd79684588207c9402b86f2fe04e8f782d12ff58cb2b3b5,python,19,11,8,34
NB_9f1f9db5c4ed13cdeb10ee7d7cca4261b0afb44b9853799362a70a6e395aa384,python,80,51,29,37
NB_0cb86351de4105a6014745db5fd7d71650746faffb7bc477bfe48024b4bdc3a2,python,6,6,0,0
NB_7ccf15d01ff12a9e32d30d704d3a60e2894578960d9f05b252c33ace061f4e57,python,14,6,8,77
NB_9f299a2ab1eacd9855a6340821262f8e9aa6a8f83ff759a145ad442a61a26cec,python,24,14,10,10
NB_93f236ce39eec6b2ba811da1e9381a7cbfcec80f4ca4dcad26ce39235c027c5c,python,29,16,13,105
NB_1045fa3566d7e78b6aa1b3a7223558c9295f5c4a22c6d81f6e5dc79c369a1a6c,python,258,256,2,2
NB_686b017c5c20df9b45e4dc0819d7ef432e25cdc926f1a1e73b18f498d90de1b7,python,17,9,8,44
NB_e20399e1eb10dbc9cbe82baaa306a57d4ac6fba4a4079acfa21636b1603bbf3b,others,19,18,1,1
NB_d098d7af3d254276e0303012d205b1ef720d4b5b596c8a2823046b6217fb5946,python,37,33,4,7
NB_563397575b8d489b92ef1e67ec6246c4a68b151df15af171adf1fcea2de31476,python,27,20,7,10
NB_f5dd51bd927625513dad6239e0bf1648b5193d5c64fd64eb009770a0cd1d9f25,python,30,19,11,11
NB_fff15487b031854ae7873241234333834b936dcc077a1274fb2ecdc869b8c264,python,13,6,7,48
NB_dcfe78ac8f38b5fb2d96154541cee43e71c203a7aa6028788144f244d87e79c2,python,57,46,11,13
NB_e667b036493be2647f888836f046eaa265bac8757d989a37aed421caedf5d900,python,9,5,4,6
NB_5b8b99b44d9d577805b824debeeb6da32f90bdf147c89379a977fefb9f5adde3,python,5,5,0,0
NB_0087bbf7ccaf26322170005a7fc653339d1427efb31fa33aa0ad9b08d9e49bf1,python,26,26,0,0
NB_c52f864486c9a52ec863fa4ee74d144013f4bb44ad95733ff180029202d2374c,python,25,11,14,395
NB_47a6542f74cf3e2db872aa11cc96090b75b9c06cbed8e77f261cb08c7f505d60,python,13,7,6,28
NB_6b799914f23dc17dbc0d140276bf639e60bd341584f44ca084ca0aa0a0569a08,others,34,19,15,28
NB_bd54a7593715ebc28e4b0cc940b45d562acc840649b44c30a6150eabb6522618,python,11,11,0,0
NB_22c69374e529fe043aa69f471bb74d8f3aa4c4f8291418eba99bae606fdcd6aa,others,0,0,0,0
NB_42c99df86cedc7750998868d0aba2a263920ad851d673afd004bf63907ecfa0b,python,39,28,11,11
NB_62c7375d98c388b9630634f040602048d0016cb777a3a7017492a9c727c5010a,python,18,18,0,0
NB_d91556ef99959687112ac8578d0fcc20bc15d95c7afdc4b24a11f2fcc09c10cc,python,72,72,0,0
NB_42d82f113b417dd0f3ec8a7772f1f2731172c6c7279a90e2a572d2ce52825413,python,20,11,9,59
NB_1d2ae8cb4bac7b40fa0893a1bb141e6c495fb8cb64672f3638d0a10cf57e7b00,python,39,24,15,30
NB_9f3eb3b3c78f8e1667090e9315f2c1cab8ad94faf77d44c2f96c2ad8950e7bc7,python,12,7,5,23
NB_d2d39a9e78c519e83e9987665c88ea1683115596de0e40f5e5618a5630acfd95,python,24,13,11,21
NB_a6fec78abfdc128e111ee7d1961f4c45acfed5fb25c1b89c690d93418182f99d,python,45,19,26,355
NB_e8ca513cb1ff688c67c0b6cd53d0a10ee79b782bb8eea3919dd7b73ec4f65c15,python,27,27,0,0
NB_e0f2bd22251bf9d6daeba1cc2c3dd3ead9b1590418e487b6460c4948583de5ff,python,14,6,8,11
NB_b03c56f77b4640262f685625ad6ed0da5c233cffcc5e9abf3df3f717e05409dc,python,12,12,0,0
NB_c71b3eef2377583ae44d11b4158b4a02d77571d74e280b275f877eecd4eb4f24,python,32,16,16,104
NB_7c17303cee8fcd3b95d063aca775830afc76df9182f443a2084d5645f7843981,python,56,54,2,2
NB_3c8e02a138114765bccb93e1687f93ae3a4eac7cde3f1ce24db274bffd38c158,python,60,49,11,37
NB_67506f52951aecc2cebaf8692f5cc20a192660239f812d51c1276b0c402a8b2a,others,64,53,11,23
NB_6be930469a3038c8f28e5579960a54a3cddc08a3774c1ba45c8d86a4fe771b5f,python,2,2,0,0
NB_b9e99a5f65e934d94a1561fab25166064ea85fad68cfd127891fab98839ab01e,python,71,62,9,12
NB_c30d16d4d6cc8718141e4ec4969ff1ae4079f84a526b8f71fc0bfbd28bb50775,python,2,2,0,0
NB_f82d7c55e1eb2864e37d0fb7a003ec10e5cf72ec734858c20758cde8a6b7a635,python,13,7,6,24
NB_b36fb67073520defa517569bc5707ecb7e327e3bae3851d561a6eaffb98e2aca,python,25,13,12,39
NB_7d15accd8ab5835effdc23e3467139f8f091a2bc6dc0f1999316e0a2b624ebf3,python,55,53,2,2
NB_ea9c0a7b8a8c1d91dd859ce46f01b55e60d31ad5d68136389e71ef12fa3c51ac,python,61,60,1,1
NB_a9d1614c9842ce8ddf2f752aa2b42058a96a97db6282591a4d21d164efc3463d,python,9,5,4,4
NB_ddb2768f8e1d9ac848dbbd34b0071a0b5dee00149c6d14832934a3be95df521c,python,21,12,9,110
NB_0cee3f879563535dc23f837224e5f907e5387afd1957be9b1824cb426464a783,python,10,10,0,0
NB_7a2f5819b1e8d7f59c2307d091fe61335e28cde3a90c5d9c08868b62ac30b326,python,17,10,7,7
NB_bf2567baa8a40711dbda05d387eec3fde3e321289e2a58c9d7989d4f64ae494a,others,51,39,12,12
NB_595ecf6fa77d2be2591024e60f8bcdaade60b746a9a91f59727d61c202aef388,python,20,18,2,1
NB_e65320f5320f799cec7d1bfdef53f9dd3fe94f7753327c55c402fa5413714465,python,32,26,6,6
NB_2340bd1a97e6ad170439969f2f7a82a0b85d4167309d20fb9baeab18135cbe43,python,7,7,0,0
NB_163f6b6ccd8e0581ae37d0b04f69502ff3574b7d4c758a7291bac0ed0facd8b7,python,72,66,6,6
NB_28c79854cc02fcee39590981ef79ccc0adae94eb61c6180f34163829cb442d4f,python,32,18,14,148
NB_02a82937578250ff19fa9cf1a260a59e1b034574f0c7ee578fe37cddec963d4a,python,2,2,0,0
NB_67643e9d17c89b88c94d620e52ba73a48d3b779f9642a5cc4c28e16ac88bd071,python,4,4,0,0
NB_b8dea70909ddc91df23ed34103eb16e8f17ffc3ba20702f5b154091cd3bbafcb,python,14,7,7,35
NB_fff5c1b9470ba76609f5b0cb00084a0c43e8c52eacd7fc5511caf089df8643b8,python,60,52,8,8
NB_6208797c54751a37a0bc7fa998d84640542d2d0b5a94341a9562b4e0fb79b1d4,python,17,16,1,1
NB_4649292abe8011e26956b43c7dda6b97d6606ca5e5956699894f635f4f70bb0f,python,39,18,21,39
NB_0cc983f8d529d28af703aff32317b2f7d3f8d67428be55825cdc6fddc389ae20,python,77,24,53,105
NB_2134de88d4c3b4380e0871c23bec7c95172e82039e52b1adc61207e6298c6745,python,49,28,21,54
NB_c5baf67d0a74842e7933fea21ca75e096884eb6b585e8995956a6b2d1e7b6f92,python,16,6,10,34
NB_4b6a1b8930fb976d44936528fa8f8c4e5a01e3d2823e143091a990fee2618e45,python,16,16,0,0
NB_fa406c83a507aa74515e0114b99aa420a7eb1ce9373e07fa0e5cdb7011aae3ed,python,28,28,0,0
NB_fd42c6e8afce940c062eb4e3ed24ab8d867ee816ab14311b63c58de5b99efa00,python,13,13,0,0
NB_951a6036a1a18c7e5ea42a634c051abec8f41720fbbfbbe3dee59e14db4ce42a,python,12,7,5,13
NB_b0846b68cf2ddc36d98f4c12294712164c26e4204ce8310dd15e6a02c60d8f65,python,40,19,21,21
NB_33ec4c3049df46818324195e51e27c4d44b68d6eaa92cbdd5fba350ec2f98d5c,python,15,13,2,2
NB_7fbde6ff22192f3daed234758c94aab1095f0437bb0062c065cdf4b821641452,python,30,16,14,93
NB_3e1ffb41ee0348e839c729ff8a5ebeda649611f3dfee71093fc524d3fd0b553a,python,20,8,12,117
NB_70c9c7ce8484b674e5b3de195ff0ab62b94dd317406476923acaf3e5377e9265,python,21,10,11,53
NB_22777152d207a9d39f27dd410c5eca8d7d4eac81b1b2dda0a12b5e77bf5215a5,python,66,28,38,49
NB_3667c60259cdc645f9ba96e9fb1b2ba1197a7f5b89c9655aee5d61f0c2873e50,python,24,13,11,73
NB_7d8c1b6ab3487699f86783f99e070445b3e14415f12caeed997e00ab58a176d4,python,16,8,8,16
NB_6dcd989eb0989e2d71281cdcac07563b7b05fb78a7a29de741f5e160e625f6b8,python,14,14,0,0
NB_79fb89c9d236e546b89b33306b58ed78083af251adf7a067df101392e5ce0bc2,python,20,9,11,11
NB_68bdf01cc789e718d505470ff27ab8527d57085f70819cd1de69c0b5475cc383,others,0,0,0,0
NB_50ac128419572dd5704ef976927a389ca4f8a661d12f43c058b448bdb5009e11,python,38,24,14,78
NB_b12b88380b8e52d93a00ff0fd74278bfbc5ab71703fc50edb8ba50ebeb4be460,python,75,26,49,449
NB_d2b0502ba4829b40c86b3bc95197bd617c65fdb858aeb1474ad52357899af81d,python,31,23,8,8
NB_e260fea89397f50420f22d266cc5f3c09902115d3036ffd6c957ab9e69129ed5,python,52,25,27,77
NB_4504b8c1c25398b4314ba0fa3821795ca783b021ebe205e9446a8ea631a79a13,python,11,10,1,1
NB_6e399e28c4ad8e46c249ca29011ae7348200cfdd30757f4fc80a7cb6fca1dc1a,python,10,7,3,14
NB_2b8f407f8b6040266278d786f99936c81c116cc9dcd3e20add37a38d1a05fd3d,python,4,4,0,0
NB_3791fab42521a1e7e3fd84dfd4d46391135d2f4c3f9615416b778ccc62a983f7,python,11,11,0,0
NB_bc8cd997ff6c9d6facecbc2d82054daa54bd486eaf14bb5150fd2b1e3e59e669,python,86,74,12,69
NB_86c13290004236d6266a279758f2bb70d7d7294eec0da2e1fd32dc498b06aa9c,python,75,31,44,475
NB_2f9f3d6fca377bfa21ea54fdb4e723632f685ef3f2291c25f7a9e9d785cbdddd,python,13,13,0,0
NB_c169db2ca4d8caabeff8eeedf345e9cb1f45a1ff6ec5bf43d1319d0c76d2eb16,python,168,156,12,84
NB_bca0ef0bdf3b0ef30ea3132dd31cbb5d3611f2e108e4531df6c829f06834185f,python,2,1,1,68
NB_6b4350c52e53d29859326b1f989a6e7ffcd731669c8385072b3f8629032e177a,python,38,34,4,4
NB_8036ed2a3546a22b9f83cb913a22e53c82193b413e11b39cce0e06cc5f99e3f2,python,26,26,0,0
NB_c7478d43f327c8f5532b83f32d02c2e8cdbf385ab03109c7e639fc6ad1a6d9f3,python,14,8,6,25
NB_b518d575d42285f4be1848290c1ccfa6069ebdf92e8c797d6d621f64ee1e06ae,python,27,10,17,53
NB_b073346537915861d13554e64fdf97b75444db5882233615c2cf62f5bff52a60,others,36,33,3,5
NB_a1fc77e07d7a31b4e85f181ea3e5f87aa33c591ab19cb4ee22950b2dd10c53d9,python,12,9,3,3
NB_d7770f14435973380e7c23a1f6f742263a59992b797d0c6c8705844fb90221d4,python,2,1,1,1
NB_3bcf88eba3ba9ccbe522fbb6357e98a001b8e846cf42606b5d9ed33770fa2a7b,python,39,21,18,57
NB_81a56c6544c90f638c2cb6991b69caeffa82cb5cafd2a76a68dbd172212821d2,python,153,77,76,99
NB_571aa9ba5678cf5266010d0dc7a9ce6e3648d01b682e04587b6cf57e1e6abbe9,others,47,31,16,28
NB_b191d336112bd857a90ca7b47628a5389d068438de6e6de1b4d76e3154614fa9,python,135,61,74,404
NB_1663577b9f1550150973497d1d23f4e249c059a8962b6550f2391f6ac2303d49,python,143,88,55,196
NB_35e3247fc5b0af6c60b210812ec9f73d95213d39e57bacbc5e014f7edf23a36b,python,42,17,25,183
NB_cb7f94fb58d17eb06e7d00f9b5a0a9177a0facb5c0181421c770f78dc9247bc9,python,2,2,0,0
NB_173682d465314e4f32fb453e29ab3525a220b0ce5dcbf15c5b12b3021168de5d,python,8,8,0,0
NB_2bf7a196e6a9e67f57872cd77ef9609f0ee08012d44e49bab5f64f5de5595b82,others,110,65,45,96
NB_830049a090d35191d6a175d748af7949b92e8e762cf44b7b0a2ae69f840e0845,python,11,4,7,61
NB_2638775b9a914faa13962b4afdcd540f48b0874cba474e44350f92880bb90323,python,5,2,3,81
NB_adf1d948933de0f9491234f313c5c65a726a2118cd982a4123e6423ca431893b,python,11,6,5,5
NB_fbe00f157f6a1772f4410d94d3aa8153819df0038da33c9d5d096eb5a13efbcb,python,54,21,33,548
NB_d0b28980967911a7b1cf763043f5a3d0ff40fc95f4a48680ff2d7b92f993cbd7,python,1,1,0,0
NB_289c1a5514c8335b0cdf8e41b2f08c1649ed5acf1b9bdef61204bf3285341b1b,python,15,10,5,38
NB_895bccb2f213904fa9d1bcba7eac5994f267f90e58ae3258b1f6db31d5d8eae6,R,49,27,22,25
NB_5fbd244ea972f55d906b7b42aaf51680274fccd7c54318371acb324e9a56d2d6,python,21,21,0,0
NB_018cce030ec1dfab57bf9a1151a3757a7dd24c92781bf194c742d8c4d333659c,python,20,15,5,7
NB_70861f983dfa34c95c312b6f5365d51e7e73c8f1280b504f19702963c9e1ca67,python,28,28,0,0
NB_3e67bc811bed04bd56fb9ad0a8c3970762109c02f0b77582e30c40e85c973b30,python,38,38,0,0
NB_864b5e6bbf386c0991c87b76fbf9f1e6e539e6cb350a8bd5c10d723926c2a287,python,37,37,0,0
NB_ebc511fe315553a2e2fbd90672e9c6fa7e865417c5d0f5c91f81173555badab8,python,27,21,6,6
NB_7cc46d36448858f6ccee4bdb55c4f03545ff55e8eda2dcffb8f7110bd0eb439a,python,9,9,0,0
NB_8c9cd5501dd942d0aab64f3a9e19512956bcc5be69efb3333ad82938b1d1856d,python,5,5,0,0
NB_67e3ae34060732a99efb98263738fc5d881175ed727d387ec4790532c29318a8,python,118,97,21,21
NB_9cad2b1fa05ccd5f16c88256b77046f1a24faba45de32c43ca90c3874f8773c9,python,52,45,7,7
NB_7b16ba6cf1f0605654d1e4e8d88a7bdc38f2aab3026fcc0fda1db89098c9f8cc,python,7,7,0,0
NB_0de77fdc259a1f6ff8bc6b898cddc284940f67e3dadeee83b44e34932f653e3e,python,49,28,21,199
NB_8cbc70328acddbf630155cb3be6ee1f105ffd0fda17df9c8da08bee5be5a6a5c,python,56,30,26,61
NB_ec9bcd37bb8a2cfe0e2fc87e03d84eace6ae0fd0c376efe8e9e9d0319d7f5a3c,python,22,12,10,76
NB_db5050e39d3c7fe15bb358f94554a06f5cd3bb7ab04445e95e0f92d245faa839,python,18,9,9,9
NB_47101da2fca16eef4474a6f3dbc588f99f96ebffc79a005d271ffd43ac59d9e1,python,37,37,0,0
NB_3ee293f9cc634cb91c67f105df5423b3ef7ec08ce5752a9d285071c08c21b1a3,python,20,20,0,0
NB_086387c7065f8e86b969e5ce0f628122bb1d85627ac343385a2bbe98737b7861,python,25,23,2,2
NB_32b5a8ac881b0e4f0767311f61acf2db2d765494b64a490f6d2b3b5cf354ddba,python,62,41,21,22
NB_a7ebbb062c18ce22829b536155aa4e2da1018117a1f51d7f4c8f44d134ab6a2e,python,22,11,11,19
NB_79473671e52089cfe11dde026308e357c83c703f6f07a4f88ce2f7247b5919a6,python,17,12,5,5
NB_f6b9db4e94bd2543e039643018d23b9053154aad85cde65d99e8c57db71e77e7,python,15,8,7,12
NB_0c7968fe8aed174b0b682e9990675dc37cee79fe402eae154484fdc603d94e0c,python,19,9,10,52
NB_80a6527714e35b6d7eca4c706e8783db301cc966e95c3e67af93b08f28d5f1b5,others,54,26,28,36
NB_23b18956bb222ceb873dfda4b97add6b914adb74809777c6d46c4a041eb63755,python,16,16,0,0
NB_51c98b20f7282a8cdba87018a063bd5b8cf1c1b35ffcfe79329ae74bf64324ee,python,87,43,44,318
NB_b53cd77ed15c89f2798ea365203bbf5ead131ef35f59eb2ad265b3cccd8ebd6a,python,45,26,19,26
NB_2ad3184793070da434c5f8c7314e31060ebc29ce58594a6cee5003852f4a5150,python,9,8,1,62
NB_bcf05a4546cbb6dfa794a2a4dd53643ea558636483392811b46500aead77b475,python,6,6,0,0
NB_7b12f1991fb896b1eee12376dc0bfcda2de46ca1cec85b7b2e2ddf54e0942539,python,68,29,39,417
NB_6859e61d7ab531b365c6ddc8293454ccc5509e08f17e95580c4ada680da73375,python,15,15,0,0
NB_200373e78ba145f4d0d728d90c471166dd812d1fabd70eb54eea887dc1261216,python,228,164,64,105
NB_955d1498509ab956bac66df48b1721e7faa1f92f171ebbcc8fd4227eca480ef9,python,3,3,0,0
NB_9a5e0f1d9e9dc50062f4098bbbf5cd04ba14b0ada9e8e430ef1787c4621e18c2,python,51,51,0,0
NB_423fae567baa3d63ed0e201bb6db65cdf28685d51a666280df1d02ce5fbe2036,python,1,1,0,0
NB_fb5355fe6faa0f9dfd8ca97d1d5872e7ef2274c6bfe3ac1b0d8af96a616c83e7,python,13,7,6,10
NB_eec9098db06b400e8e482e1472b228d08fcacc107e8ce920d718f5f37380b7d2,python,21,21,0,0
NB_7214d3ff86b3228cc75b51731ccbf753b67c7b71818941450417e34b38065ade,python,10,10,0,0
NB_109aea88ff63d2d62996095a5670c5850d43188c1f2281d46eb15858f7b9db5e,python,32,18,14,14
NB_505f826e303c9d4b0717238c54467f113a50003a49b6bf1197ebf2a526c0572b,python,141,87,54,199
NB_1b86be4c38c9be3d6353e0edbd5411a9c3ce6b4df5853e6f98879058af71cf36,python,38,32,6,13
NB_926cbafe6fc2cc8500ad01a5f66e83088c6672f91f83468c5fabf0a1787092d3,python,28,26,2,2
NB_e95266eea20018d8a80338fa1c5cc84c114f55e05dc5bae2141ddba47cbeb165,python,40,26,14,14
NB_f317299d6902c2511d29665adc778819060f9e54a2577767c4fe1e6f15d7db3e,python,24,13,11,30
NB_1ef0523055ff9e9b4cc4aeaa6ed7b64a3230759d4a50a45e669b55b624a03b38,python,19,14,5,5
NB_6524108c3319d60ec63d846a2715eac835c2bbb9dcf9eaa34aca91dbb9118224,python,13,13,0,0
NB_1cebfe8e20018bc897f6bca5ee456c8d1044c85148030630b20deb9d4a735501,others,25,21,4,7
NB_31d92d29c9dcb7e9b809c38655fb22e1f873e5d206d878bddda006b2645aa100,python,6,6,0,0
NB_a09b536293d31ab904ed79b879d7b4b5a70473da2375eb0fc1cb823ac7a75378,python,19,12,7,19
NB_0993af8645327792dbe3609fee618b71303bb8435384f72008cf44858b4a8cb0,python,57,43,14,15
NB_35f7b732dddfd46f4eaa052eec26920d7d3960cf97a49d8e368153a8c74d08a8,python,113,112,1,1
NB_4e7853b879604418af015442d933ca7bf5e7a732022d0166eedcdddf876ec5ff,julia,35,23,12,12
NB_48e8f5a5e22b7a511179f2845f579c5a03e06dc3e4d816af3bffa898aa345509,python,40,30,10,10
NB_0d6d5e6fd8097b501dde5cb40f00812470b1a6ff52fc1676a1e425592c9a5084,python,19,13,6,6
NB_f1b5b68cc665eeae9ec14381f1b7bd35958078d2acdcc06fb0686e425ab528ca,python,21,10,11,101
NB_5f2351f4754c7f4526edc69dde368fa23d4321a012cb37dc33f2c93a3cb4e810,python,18,12,6,25
NB_f22cf517dcb6add4d5435d02025ca871d379627373d34f00a07a50eed9f76791,python,45,12,33,64
NB_ff63bf503cbc0e859c8d09216713909e4704237b6a3417d94e241bdc63982699,python,2,1,1,12
NB_65556405ab6086327bf553a28ef15df232a02d2ad982d6f3a66c47814eda7659,python,11,11,0,0
NB_0b5e7030605fb6ccd2e52b36c58e07384eff273ec7aaa2ffab995bf9da778e77,python,11,8,3,3
NB_dd5406e78db97e7d0d0c767732bc393861e5cd564c6a2c70c879245e9d4458c2,python,25,14,11,87
NB_6b8665274f47840e80f91ae5a8894443946109d2e411172f3d06a1a10041e2c7,python,4,4,0,0
NB_7207f57725bdd2d1c228dff2c5d4946b3871343cc2bfc3ded03d7f4c301bd6f3,python,17,7,10,119
NB_045e49033dcaeb6c6a3e261cd858dd7fe2f2d6e59c3bc93e4f402b34f4367319,others,0,0,0,0
NB_4b1b3d9eaad0f0e6cfa5ed184038d4b18da75e67a5ea07fa3bc144f40791b3f9,python,27,18,9,15
NB_da08f23c145d14889a380c137715807b1222bc1267799e68b730bdf22856d24e,python,9,9,0,0
NB_b952be944e9c10edec9ac93d2d12e0b5ee805abdede393897cc47e8f40ad0927,python,71,62,9,12
NB_73800b09811e02aa73c1a20d33df4e2439e5c56f2b122095b4047c75dc65f178,python,78,61,17,19
NB_0fea77cd71f5ecc809b3cb918d3f90a0722b34861b976709816bf1ea3f9cc1fe,python,66,58,8,25
NB_7e888c9aadef8d0fb550c4dd3b4f6850f6e9a3927df36894beee9de303b557c3,python,29,21,8,8
NB_20c72098428cb573eb6996c855e4b92130b7a5c6f08563086843a4efdedf6ca1,python,32,16,16,118
NB_d2c91c14b0d2c686215ffe29547c2fb4d5a00b8eb30782484a79482eb6600182,python,6,6,0,0
NB_f9e981b7228ae7d107df4fd1edbc7effc4f94bbe075d76949d3ee1210752ecba,python,28,14,14,25
NB_a0d61636ba07898d95e450750629f37f3a46d4f40a190682619364beea2e4653,python,59,45,14,42
NB_d4e7ae657c63927225c0da520d267aea382fe486de1c0e12258a400ef1eb9d82,python,15,12,3,3
NB_ea68005748e333cf000731425343df9218fee4e291b6358302f4c83e94e7dd96,others,48,39,9,9
NB_73c51d18116ca4b1f55228eca1e75c2ff9895ac155f3d68dd6fca5f18622123f,python,32,16,16,104
NB_83325a6b20ea6795ed7a31ec3a9cff2bf083a3084476295a31139b569208b209,python,6,3,3,31
NB_6efbd2f6d0bed6f50ffe82f49187c6be53e9fd4e838f81e2f3566bd1959b364f,others,0,0,0,0
NB_66f15b2503e234fc37f6aba36371a3d20d38a517c329da33d37e7627e856fda5,python,62,62,0,0
NB_2c8e16e6707e917ac543c2eb05c0eab7b1e911b514c0beb0a0ec4d90a9e9b7ea,python,12,7,5,5
NB_da869dc5337fe35228f0e1d87fe62e75c5696561d98e9822f53d2a49613280c2,python,33,22,11,17
NB_ddba1b858dbb27583f2c2dc44091f19df3d063fb5299248d8249c6d3461064da,python,32,16,16,118
NB_18402c06d6f7387292dd8a77f4de556b81e97994560ce11a067fbd75034ee463,python,28,22,6,6
NB_b4aaa55c9ea19c7bdc3a7d244a07f3d35df406c11c94b36877257674fd467bf0,python,8,8,0,0
NB_56237c9df2ba8e32c0230290dafa6de9f58a45c9d9d029bb8cc69a0736cee092,python,30,21,9,9
NB_c63195faeb71735ed7823c6b21043800fc4bce3709adcaaa1b0304137fa009a3,python,7,7,0,0
NB_e1dde13f84752f4cdfb758b2f0230ce9dbe2834ce6551e70c3afff8d2838da08,python,24,10,14,121
NB_aa85680fdf06c00cc18aa8a48213f370698adfd472d513e46afe680975ca1472,python,22,22,0,0
NB_08e081b60e0220e03c77ffc901970d08c153623e25f1fac262dc29067613b5f5,python,11,7,4,3
NB_0e7efe90285f93eaf9a17f0db47dab654c1606b55e44128a808b9e9cdfb7550c,python,7,7,0,0
NB_9e8a41de4977c5e3df29f62f8ba4426cfba379cd2ffb7108a89a451cda7a07ee,python,60,22,38,397
NB_2c2430b2cfc49bbb0a867dc89f208ea91755915135d8a34fda8ab54caf3fe62c,python,1,1,0,0
NB_29962e79f73f9f1bce59b9c338dafd7629cc4bf6517d096b69afa9d81bef7150,python,44,17,27,279
NB_040a9a6ce74f3a5f6942270e20946b887071487e6a30af7660d18e93ec20b23f,python,341,171,170,403
NB_5ecb59bb4b45495dce83d9c7734d4eed76575f2696e44e238bbd0aab2fb54af4,python,6,6,0,0
NB_cf42bdd4a8e96ecd98c3ba8dc8c9e7d3dcea037536d9569198e4ffc4635b3adb,python,11,6,5,5
NB_c689e57c495c03466372f0fe49821fab07eacecf9b0becbbf58d84ed76ae547a,python,12,6,6,112
NB_6b068798e6b5ff6850ab6284cac6ae3c444ebbc2ce32fd14330cfdbe9fd78c5a,python,43,19,24,83
NB_86263fb34df0a08ffedf7000f8248eafaae3eea26e2d235f4d1af3b2d929e059,python,37,22,15,21
NB_4543c522c4ae478c0aa2f14c518310abff424a8cbdc65be9cbe2bf11fd6a11a9,python,1,1,0,0
NB_4eac22fb2cbc158090b2ea6f1c215bac16c4af9ad3447f42857d7bbc5fbadc2a,others,32,27,5,12
NB_633ffff10d9f13ef8d751062f132f83935ffcef23756a54fd350679e7755f1e6,python,8,7,1,1
NB_1970ceecddd37123072834331ed9fa9b78abdddafb18ab4650c21ac38a479369,python,35,33,2,4
NB_9669c20e3cac60ed15ed8ce05c3ae2009a702876f8aa5d8b2c9848deed6fa0a6,python,21,16,5,5
NB_aff461b5d4c40cba1057a11e5b3f275b8a1df4b4555a62b782d185ecfbc6358d,python,21,14,7,53
NB_c19c1faee55f9fddf613efa3ba117e266c1263f0649e8906d6019b0b5e918637,python,24,13,11,45
NB_1bbc5abcdeffe06e173704a7b0c5ddc54e4ead85cb46fc38cfdef715ce83f324,python,26,26,0,0
NB_ff72dff9c2dcfd393241e2075b91ccb8f3677d059d8bd68ebce24db184740327,python,39,23,16,99
NB_f4c5c803b4d8a30cfc202fd8ab561e15c840448699a8e3fa76fa0c767923eede,python,16,10,6,30
NB_32d153472dd2989c627bda5403a9878e96926895597a0cffa91ce4db166e5396,python,20,11,9,28
NB_14dd9d63deae831c99ba7d4e2d02bf327daf37b76c4d1f4de56232e9deb6f62c,python,23,17,6,8
NB_2d5cf5b452e0e8dd3c38744d8bb469c312163369fa14bdac74cac7d2a77368c6,python,13,13,0,0
NB_8c5d1abb4e58457b36927b32b7df15e822bc13304dfe931e79786acc4c3b4501,python,16,16,0,0
NB_9e9ee6a9cf8d8b6aa29cd1b90e7ac60842902800a54c949db79c1d08772f90fa,python,21,17,4,26
NB_c84f2386965c5d9380508b216eb5c05325cbc560e7b20ed60ce0e27b6bae7c77,python,13,9,4,4
NB_11ab500e7bdeb6f9c98cd7414fea1d8e5177f175cf1567786313a4421c504eb4,python,10,10,0,0
NB_a5220357fb796c69649148bbc502927348bc4d803840d2d14b68d9b36a1bce92,others,24,23,1,1
NB_a7da87243092af0bedfba1f1808a3da48e245e3361a4caf327ab3b2106f429f6,python,15,12,3,13
NB_bcd34a50bc044f4ecd2fb6ecd318fb6e64c5f43cb577d51e42200146efb92554,python,57,22,35,335
NB_40382e8b18c693eaa85019091db1c78d27c2ef2d8f103608181b9d05878dc703,python,16,11,5,6
NB_7763e402f37a55dbc0e0abb6a6a300228eb8bb42b04e6abc5ff49c426a309afc,python,4,3,1,1
NB_c443a6b80fab2ac66354f273337e43e65a67489f2a2b3e47c89f1eb86bc0f7cb,python,22,9,13,13
NB_2b5cf9254384d18ee3f769e0b7038387afa01f721c7c4d9056a7fb9ba6826e37,others,94,55,39,44
NB_b99995b33b7ed4ba697f0554939b511b4e596db4a69a4d31a9089c0730804481,python,21,11,10,48
NB_08571ef4ca56b678dfcc45d79c63fd5fdd4eb0dd783ea052db86ad04b3643f92,python,20,16,4,6
NB_7c570cce5909abac2dd1cf1bf2bf193127b389003d211d8fc9fb68a6ceb46c90,python,6,6,0,0
NB_8643f9be3e95370ef02fe391373fe29fbebd66fdfbf0a92bf8a59f1c6c0a3429,python,61,21,40,175
NB_c93bbff75a662f7ce08ded1842c970fb0dc2c7d0150e0627d0b0701660498ca7,python,22,18,4,4
NB_c89344cb8f024512aa9cbe70397aee62a5ed3addf15f66e181264f338451d092,python,120,103,17,17
NB_980d408725c5d9930c32cd3cfc4b5485f64fac63aacfe937b6ec636f2b7e26dc,python,2,2,0,0
NB_0133dc76344a381eda932858a6923c5b7f6edd68347049bcd8e736760739966e,python,94,38,56,166
NB_c9015422b2db083ccc8c1ce03861b19bb55c1a2eb60d1c7032aeb68b8f35880e,python,17,9,8,8
NB_a41d04e1578bcae8df858e0805782ab2a11f3651b5847c717ca9cd240ea2c1e5,python,8,8,0,0
NB_298c5cbf3f657239ff981c344f11e9b5c50bcb0249d934c31d2e89328129642f,python,2,1,1,50
NB_829d36d9c068fa41f1a3cfc5d7704b25f7389310c9914608f12e54e2bb0fc8e3,python,1,1,0,0
NB_2631de3118ea9e15bc2a296a6b6faf65dbe3c061fb3eef40c8b155e2aa87906a,python,14,14,0,0
NB_e5d441b08ba6caf6d434dc2c08fcc5a9be69064de4a73932cd39efe384cbc64a,python,46,23,23,78
NB_4f0e169653903ec229210b4698c36d329a81cd6f96356e0eecf3683f5146c46c,others,48,43,5,32
NB_d35034dabc70ce24ed12c7ab72a85dd17784acd73603d1bd7f4fc23bbecee8e8,python,41,11,30,139
NB_cc296705dffcee0493b38dcb18e0152b955a7201219f60ae1590c2ab22f8cdc0,python,6,6,0,0
NB_1c108bac0978d07dc62870178e8b9e903291f5d09b505cc131053e31a97edaf2,python,70,40,30,42
NB_8c3313d664b5162ef39a80c6f104379d882ac180a41ef78ffb073f925f10916a,python,9,9,0,0
NB_b01a4711655df3c2c86d9de865238cf815d7fe28f6a2f98af909777c2ffad2bd,python,25,14,11,11
NB_8fe9f4fa719ae41d4b400baea1b818730e5215f43418fa18f13edd857f9d27ae,python,3,3,0,0
NB_78a3649c209d7ec9f6cd9f742fbabdf978343aece20ac842e8cd14bab348e103,python,51,24,27,626
NB_c8c58959d72ea07810c1503e9a3722ef22e93ba96e67e4acd89cdc0c1e5d1a46,python,40,21,19,191
NB_310a395250d50a3e591d0868b4d0f26f146cf71400ec99e75ef46a075055ae2f,others,110,81,29,40
NB_c2e47df458d76b0058c85e24ff32b77f28bf29b11155d0cad7a704b4b39698cf,python,15,14,1,1
NB_596029c030c447206fab11f4498934ba72a13ee9371d5b49c2f500f542f55a1a,python,9,4,5,57
NB_80cb0da90acd33f2b913dc42ef1494abdea214c33ab361ce8bc65cd54968c00c,others,47,19,28,100
NB_a5584102a4260ed589b98dbd4b426b051282a60a34488a610990e3747086e23a,others,19,19,0,0
NB_52e3c5798c72838f76f1dd27d1a23176ebe1889d677f03d27471350d3f13d9a1,python,50,24,26,75
NB_2ea92530634a0dfc68ce9b388c7d9e194f791b284849f3d1f629da72f9efcbb8,python,80,80,0,0
NB_11367e78da71f555a216f5f8b9a46f69edafadb029eaf6923f84acffd15a11ad,others,28,22,6,17
NB_342700667c17fc8837a88289ffbf36dfe78407c8228ff16262eee0825611814c,python,80,78,2,2
NB_a3818668ab037cea2a0bdd7ee63e0faf5fcb7cf9c90e1c9d4d22792eb21543a8,python,4,2,2,8
NB_3c45ea7d7b8a1c62521176fb2647e676d8686acb719f05fa9eeabf61c0452eb2,python,69,62,7,7
NB_15e722a6815220c1baabb7fec55046d4bf2669ea2495a8cccd21ec73b4a53a07,python,28,16,12,57
NB_86201244c40f2b8fd046b5bce2c8fc45065da80be7a7910a95ce9e3f2e4ec888,python,12,7,5,56
NB_6661de4c65cdd53e0792fcb8841df7d25b11833ad2528978e27b3b108412e4e6,others,77,44,33,33
NB_b75748118f5117df62a0b38a56147e9a82b27d4449cfe0b8fcd8f5e20b402efe,python,32,22,10,296
NB_ebef7cf7f48a593af161fa9a301f88e34494a36c614cb0d6f8dce2861845e252,python,12,11,1,1
NB_05f35a6ad966959c931fc88ac0a5e22722c1d1d6ec00db20f3205846ddd11a2a,python,102,80,22,41
NB_506bffa42e951b2ce4b469cb8d5f9ad5fdf56d21faa22f6e5ad62f81db1bc433,python,26,13,13,26
NB_117f421243509b0c74b2b42f6daa67c73914e736808026315f89784addc45305,python,13,5,8,193
NB_ba65214f1be128c9be402b770bd4aab5c8f8e8d615a396f5e398a97962c8ecbe,python,131,122,9,9
NB_97cea3f81b7725053f3a07013ee8e6e9dcbc99e9d185eb7d9d1ce5292b849e46,python,6,5,1,1
NB_1c56ed7d9d235d0df2343d72ff4c1798934c3c0e7d25132b1a4e3b5375118cbb,python,512,206,306,830
NB_b659337583f3f11097a451bf63fcfda3f941baa99da929573bfa0859c9e39d30,others,6,6,0,0
NB_0fc9a48aa88a46f8dad97beefb2084bc3c3dc53f17557a5912484499c9d6299b,others,111,93,18,67
NB_3be77596b90f826d0a0db1b8ecb4f80808be98d7b194d9e74a8d7d456a1426e3,others,48,38,10,12
NB_d74aca64b4d955c80b9208c04955284013d481c1e639d636c7b3666e48b1b2bc,python,15,9,6,17
NB_71a0717d3228b53e243eef18cb509536a715d022fbb59b829449e23a7b365190,python,12,12,0,0
NB_358314d87e9d2c0325f3fd02dc0d844be9933d7616390a82ffccf10afb2a2a0f,python,4,1,3,146
NB_3ca85a62ea988b8582d5ddd1bf85ebc840e70e20f33b14074b499bae469a9cc2,python,10,7,3,15
NB_0922d637bfb98ab535ef6b608caa9a9c53460340443a63790759f4ac07193313,python,34,34,0,0
NB_e198a844b3ae2bec651cb7cc5b2d28bd073dad03ff7236a27fb78a810dcedf72,python,3,1,2,99
NB_0dfc0d540a940aefb60c80cb9b96ea33f9b3b74060c5ec40f3f7d2b1133fa30a,python,34,31,3,3
NB_ac6d8da7973de0e9c2c59f9feab147152590e7544c1e9bb740dd3bb3082f6bd9,others,45,44,1,1
NB_6ecb67a945b51db071e98cb70a029c415ed13e4c1150fd99c307cf308daa9168,python,27,13,14,59
NB_479f7961af8c7cefc8baa19aa8526539568dc922baa8c7b60662d8899704c837,python,5,5,0,0
NB_8dd2607e6788350743621ddb7f1df01c9b69dc5392c07fca63a0ad4cf8f9cca6,python,26,17,9,34
NB_bbbda5e09cacfda8b97279c050be20a2d604af7a00f7f487d2a3e66657adb68a,python,52,13,39,232
NB_a16d754743f6abccfb5f77c33c2a60742978cd67ea4a3421e7e391567fcc4766,python,23,12,11,43
NB_fff9445a7365bc668edff67e608652af1add8d8e4bbe17bd59913dc8e73567a2,python,41,20,21,224
NB_be976d24e3c79ab11440db0bbbb12906a2c4deb471e1397abaac23eb1011c27e,others,69,37,32,36
NB_1b13d3ca803220cb141fe6b3159036fe72019ada0aac6fe0b3a4f6374489af40,python,23,23,0,0
NB_3db1167a4ca49a8de0edabe0d606dc3d39e2f228c255148bbe65890320577128,python,27,27,0,0
NB_0ba2c416863f7770ad9c1dd8c4c4d74ac65de0f0373bbe7bcb3538ea1eb35769,python,17,15,2,4
NB_421085287a9a1f9b1b97eb6a618ea36ff6e639ae91c94c7024eab4b576b6271e,python,25,25,0,0
NB_b294271ca8e7541f85eafa0150ddc34b72360444b0413a0ed68b98f14b57f223,python,31,17,14,22
NB_8b02dc8ade82a2af8b6cd64c6ba69430dfff463986221885acf0922ac07d19d6,python,23,10,13,13
NB_0714eeb98ed6651ee62b93a34236efd00c350ced8bbcfa25cad28aefa1ebc5d5,python,25,23,2,3
NB_cf8d2350419f0d2f7b64302fcfccd40927eb09358d2c3bd6d27232e04840a8ac,python,21,18,3,4
NB_81396980720932b4cbc9f47fd68a83e017e47262a63602499d459e7c2c6ffae3,python,9,6,3,9
NB_cb119fbfc3175de559ddf8c8a8f728283f335cf4337783ec4046a34266f8a239,python,2,2,0,0
NB_78ea74f0c70642ac3b643204cac03df663dfd163e8de10ce3a07829dc677357b,python,40,30,10,10
NB_04900f556616f3caa734f26e7b274a157574a461ce55670c241f126679764758,python,199,162,37,37
NB_0d941008e59a663b093c5e6c7e43c0b0f0e52e5ebd75a74f9eb013e4ee4c48bb,python,4,4,0,0
NB_bb890a3b3c8a4721b46329b6f17eed996f204e9539ad3e5a8e94ced3b31a55fc,python,15,11,4,4
NB_61c8cab8b75b13f21dea46d922f852e7bda5755e58a109bdf118c42bdfa507e1,others,77,44,33,33
NB_40796a45e75874a5d510a188491e63b196af3b9ff2d670a2e907df4a63ff7b0a,python,10,10,0,0
NB_3222b3028486fc5ec6bac25fb269f00d1f921ab0f7ea52684a96821ad10d9459,python,26,22,4,4
NB_e20cdb4e32e893269b59459c27d9ea95d4fb45c81fc1755c52a390e214d96181,python,28,24,4,8
NB_a3f68f482a3c2bd88da35ff0ad27bb59e13bfcb04492e5e64998efd6a82f98c7,python,3,3,0,0
NB_f41e44b17646de4d4affee660dda59a361dbda10c778d58b2e1a0791083c52ed,python,66,33,33,66
NB_130a4a375bd6de1da0f720ba5ab376e3b0412ebb840ea752dbd45e66c357309b,python,12,6,6,6
NB_5ddc74d31658853e35d289637c3da539d77f527573fa66ccc4e3d5bcb90b5c32,python,22,19,3,3
NB_274c35ba9c7457972e6113e6905811d35e4e0151ffd8fe85f5483cdd6f7eac28,python,134,88,46,75
NB_b66f02207b1f6a4e77398f0ff24ad523b5b2e0d6d7e0fae4d006af8d39197de9,python,45,41,4,4
NB_f15e2a72a3f236fed937b8a7ef595f69641e7f43a4dfb9f37d6df1969dcbc3d8,python,11,11,0,0
NB_ce5a956430fd4bf26a260fe31a96552313dce765884b9defd5fb623506c00bce,python,34,26,8,8
NB_6dc40f97c008d211f5ed9c231e6941a0ce819944e02a86e39ed44cffb960098d,python,22,10,12,18
NB_5d8c172d1c62d0e946f13c0a8b7b197ed3349b24fe1c52f4b149dfb38bf21ee3,python,27,21,6,6
NB_635920b4e7b93f5a8acba5822561dc934147e29e7ef6e7e070b4119dc3086119,python,3,1,2,7
NB_bfda83136407009b329e20dd8d181f2ff52db629a096c494161ca7a26f51ce6a,others,78,45,33,37
NB_3546cbbfd8dafef517bd06a2bcdaa3396f6683479aa1341944d3c06d45a94f86,python,15,6,9,105
NB_c0d25d1f4d7be9216dbfddf17482a9b26b0342aef8220c64866507e9976e7c6e,python,46,46,0,0
NB_cad63542728aad38a86b183dcb01f19471cd03a02c16309d966ce34fc30fe4d6,python,28,25,3,2
NB_018fd86d3dfd0914e2e270166d7b70b2dced6b71dbd36ec73b73a69f50299cd4,python,24,12,12,66
NB_e718b0c5f049e22d15e050b6bc645b9ed10a71853f3b873858ea69e36e62f0b1,python,7,7,0,0
NB_ce23009fd26878b78dfcc2c0a4b1e1cdbbe1645130ec040b7784294fa1e86e3b,others,4,3,1,1
NB_c3acfe347cedced84ed2e1521bac8d74a3336dfcc564ca34c5cda36444125f5a,python,45,26,19,20
NB_bd7675f12dfe8a7b480597cc98ec759489955e0994448b4465aff3603f566225,python,161,127,34,34
NB_5079d2cb6d4a74cf56d4328d2b128d73adcf7ed25b888d58a2959faafdd77758,python,18,11,7,9
NB_066df5c3b60f88ef58e9badeed9c48449b33fc1ea53ef6b493fcdbec0e9ecd8e,python,12,12,0,0
NB_936885014db3f96d20249bc0b9b221a96fe491781d21064aa6b93a26fe03f3c8,python,10,5,5,9
NB_f4bfa006ab234619c1d57cda3b569c1daf790491200023b8f626e4bab79733bf,python,14,10,4,4
NB_d7498977b98f6191a3a71dddbc7230439762a735cf0bc94e5bbe07d42bc2f993,python,95,61,34,158
NB_c88c294d13299a97446fc6a77cd1c0601e7785229ff89c6c3cee205cf7f7a7a3,python,17,9,8,44
NB_96ab49c99f246cda032b1714053ec5b0314e43907639781544a3513aa2fe0128,python,70,35,35,134
NB_a350b1b3a86ca674f7c5a4725fdfa58972a33a2d65382c803a09b28ee5444ed5,python,2,2,0,0
NB_9549cc18aa66763527ee6540afbe5e6759963d25f363b9cf4f2801bb2078ed6f,python,10,5,5,5
NB_db9768701262b50ee18a9d1e890d492ed5af6844f66aea30b1e4e349d668326f,python,12,10,2,6
NB_4e6f1c484652a3d33b1ca401312eaf2488606c46d87a9e0fb866d6568313babe,python,6,4,2,2
NB_895b63e32d9d0e896814ff1ad66e58148cbe4db2869238d8cf7ede05e4ca639c,python,11,4,7,61
NB_0a7ea4df3e81eb3abbc5a60ffa6eda353a5887e8fe45356cbd64b88b7c83cc18,python,18,17,1,1
NB_eb05ba2f214cb2d5d79d7f5f8af14e24460e4fd75864869de568abf819068efa,python,8,4,4,34
NB_4ac39942cda3d5e81b055cede91f5ebfbc07dfb4293ffdd47e3bb2294355944a,python,58,22,36,350
NB_f049b305ec31482e1233a9775099f50b43265593661f0cc846e1abd79cac0bb9,python,60,32,28,89
NB_357a2c1dfd464f220bfdb54378076926fc209030c5ab0bcd5eb38fe36ecb80d3,python,26,12,14,213
NB_145fb670ade708dddbff261c8e5e93c017a99e6c72722eddf94f4b640b40df25,python,10,10,0,0
NB_8e2ac736d190cb4bad9141139b8a0c098946e1beb1a7ac0091c8cd7b04436d2b,python,27,15,12,38
NB_c4d62708ae13b18c162d16a2fdd94111ef4f7d8220095375114c53ca0f3f3336,python,10,9,1,6
NB_21fc33c4501ee61ec94ea027a6bf3c6af49c41177a804f424f692466981129a5,python,56,36,20,105
NB_74c585b70aad4ae4e632abded4de3544ba0dc07ba3208c7faec3ce1d25e7fdc0,python,15,8,7,79
NB_de146de9d31ab24bd4f217f6a2fc88cf16c27a37237f8854f3503a5b123aef92,python,53,16,37,111
NB_a40610afacf78f2d575e662a8d78675e43a976fc2d4c5d1f911c39bac9babb48,python,44,22,22,188
NB_92553764d06e77bb388146a5b1377cc97bd6cc9f0a0486517e36d1cbcd930802,python,1,1,0,0
NB_801042ff150574a8b375405b1f2df3d7f22a4117acce84b534405026afb7e909,python,5,5,0,0
NB_3363d3ff4ffc6a994de3ace3411e120d08848860e94dcb5f6e86581ceb7d3497,others,16,15,1,1
NB_b5a8164f2614b85f6c193c1b661c5ef18fdcbc968bb81dd0c4bc44ba2bf83da9,python,2,2,0,0
NB_4a67d6ec6f60b9e3246455bde252206a1a7ce16fc32d112b316643c83c727cad,python,7,7,0,0
NB_a5f0e2cb1c65b0b60a4b8e5701d39859e5c9f67f55f4ccfd34452c349ff2cfb6,python,18,16,2,26
NB_e84b804069d8b84048babb27863900dd20dbae1ebdb01b9b0d3b7ab7acb68ed0,python,90,79,11,27
NB_ce1343dde9d171b510bfcc7fc280a26efc7c6491abaa46b0618d085b04c20fec,python,18,9,9,51
NB_c05ce9eb4c92f651cf289b197be69fb739663c2f10daea8c0567c13c86503f2d,python,100,81,19,57
NB_36c1b7209d51b81bc6acc08f5be59d84bd763cc6ee95dcb08db8053244833778,others,0,0,0,0
NB_43e0cc2dbab32a61319284424aa7be5f97a7aa61f8bfdeb8bb0357a74be88762,python,24,13,11,37
NB_2cc7ce233faf8c01c6a185b6c35dea0d54cff147f9051af2b1c073928ddfa2e7,python,19,19,0,0
NB_a26a834a43dff0916193f10a0b3add39fd169010cfcb5c255c2c3150a4f3099a,python,8,8,0,0
NB_3f47214469ac790c0404af9cae4a3fb078cd45ed695c2d882f0952ccaf448ed0,python,60,60,0,0
NB_bc46e0fd84ffc3d923dc4956dd563dc280e3a99e4928ec1fc38569063df01193,python,11,7,4,4
NB_171a26ecc4f2a20df33a1f634f136cd2f239f4f37af557d1ee86c6615c144d59,python,4,4,0,0
NB_2efe41d71bbf26b72fa47304cbfe62113d80e65b2e7fe01043d07d46dea6e68f,others,14,13,1,1
NB_45f1456c74f0608a698419f3561867da059f814fe1ab4fbaa57a35512a4ed284,python,16,16,0,0
NB_429c6e27a1ab63ae9b4eea06d0f47f32620996d5568b2486d280bc58eb7253e0,python,38,34,4,4
NB_dddf86777ec800352849cc90c352feb6e8ed0b78b5736999cc217ff9dd6a653a,python,12,6,6,6
NB_202d843abed3a424a5b3d6792ab1fb274ce571ed9dc966f16f2e9e6c97b4c4e8,python,28,20,8,12
NB_8e09f3c442f1bcd17c8f3de169507b9f7f693ce3a747ff6af6f7d4860fc5f89f,python,13,7,6,34
NB_e620abfe76e829434e396806c990d0fc2cb7b01dad03eacc3bd68fcc2013f9bd,python,17,12,5,15
NB_4f04d64d36aa378aa95fadc79d101dc5e4dd173b14c081bbdf00358393ea3b52,python,17,12,5,20
NB_e77615a13b3937c334ddcd34f3000ff1f81dd6578e9667938110174c3c1f1123,others,49,44,5,30
NB_41b6f6931226270ad780af5c86fe11c6b772703724a4ebd8fe846076b56726fe,python,486,365,121,128
NB_a52c191bd827690cbe73ca711b87875d60b435583e9f36f2e80726cccf9baccf,python,25,14,11,72
NB_4ea070fa7a6242cc9ac781582b9d63445d9833d464e8c7e0c12a1d319b86d2df,python,10,7,3,3
NB_f65f698b8e9ca6e397df2dd9abefda002d2228e11f5d91fa47f2a079c7af3777,python,26,19,7,44
NB_4f8270f62d6774afe79d88ed5f0e6f9bf6c6577e3d58ab1f8bdfcfa620bcaab0,python,28,13,15,34
NB_0bcf6ea978cf3c4e4b2e9367e0d1bccb6f9b8101c641d09deaed1f89536dd769,python,70,61,9,9
NB_307ec8d2a80070a3c305cf31831398a389041fd1fc0d3398b21aacb62fd5ca17,python,27,20,7,7
NB_443effb87dba9d27160272110d9dc17df7d9901afd2cf52871791dc760cfd77d,python,97,87,10,10
NB_c05fd128487ee919947a8a8e3ef4813d6896704f5d5d031ff8796d496d91016c,others,68,36,32,38
NB_1618892e454071b3895619b36192d7ca783f5658db78289297772ba36834faa2,python,28,28,0,0
NB_0eff8bea6cd6f03f35f65614ccf96c7dea04cc6a1828e9b41ee12c8d6e202a6e,python,10,9,1,5
NB_ff8e2e89c0161ecd5443c76b9ac4a310a1ab6bb1a5dd5c73822cd4ed62fe9aa3,python,121,116,5,5
NB_22258c338b6369fc902c471e4c90009a28f461c85a67c846dd97b2debe72ce45,python,13,7,6,51
NB_e9f3459d91b3f4e023f8a7944c80e450751d789709492463c18a2488137a626a,python,8,7,1,12
NB_e7a2952f1ff39bd21d575aee5b711f7db32497dcf89147be37edfbecfcb2c477,python,12,7,5,37
NB_2378ccb1381e8bcf575d4e60f35f100a6bd16593d0d762f3fa5e592aaea3f323,python,8,5,3,3
NB_a61fc5652afe4910d64cec3d4a54b017e1a9eb295de5fdd0519239f1d95a6aa3,python,6,6,0,0
NB_ddb8bdc55e18105053f20047488e46b6b6bfba6b3b919feb52af4902118280b3,python,24,20,4,6
NB_1496621b111fd711d21031df08c3720de4928d08fc2118e9810021c9e1fe58f3,python,5,5,0,0
NB_7aa8b939207371ceac630ec63195c0ee87fd56fe3f63ff8d44fbdae7f6ef9430,python,21,12,9,57
NB_dacc806febde6138ce1cc52ffeacd9e2ef2db62a9d5a30d3efe9c2efac5a7717,python,57,22,35,335
NB_1fc407fb9b41ba203870d3de670610fcd3078bbb770eecc6a247fefbea8c2cf4,others,4,3,1,27
NB_73afaaeba23f9f7115e84ec3311982f78c1ea3488a01f0f47a466f2615db59e0,python,4,4,0,0
NB_1f933fae3f697e8705e8e38cca29ba2e01eb9b1108c1cb61efa27a19abcaa913,python,26,22,4,4
NB_25f3d61a50531e9bda8d6121dcd4dc34382344286f30d4ff8293ae11eb6eff87,python,94,77,17,42
NB_3cc2b830a304da9ae32ca38f8cd2b508be594b5c8392a92cd91a37f2c2b927cf,python,4,4,0,0
NB_f169edeb0f707ab0bdd288c6bee59a5145c1d79b274618509039ff5ffb6f43a2,python,32,32,0,0
NB_bcb863b77718f5f2f9ac9f17d31dd0f1a41fa88b0ba17322c42cf81b73a49adb,python,6,6,0,0
NB_65816afd0e6da1ac6463d5dd792a00af787854104e61105666492722f005ad69,python,18,8,10,16
NB_c009b8fc7a8982260ed9c03b69b2cbc20a8010ccf4ddf6b10f2829e21f24ad83,python,10,10,0,0
NB_1014161c2c8995e399857eaba18c5094bfa341c7eb1f94421130d4fd21f3ffbc,python,39,30,9,69
NB_41d9ad366310673a46619382f3d160dc61f0d44291625fc575f733b5b1504b07,python,18,14,4,5
NB_6e5c116c4c05f4dc3ee83bf5c6c3db420d61781719d80be671fef3d9e844eb81,python,33,19,14,165
NB_1f42a08577116e264ea6b73ec1d6401e5c015cc3a17fce5dccbe972aa46fd5ce,python,4,4,0,0
NB_ed635ac19416a19786be37f24a3af2351525fa3d79cae0e64784d3ae8a29bce3,python,40,19,21,183
NB_c64c8a7507489ff2424978b0d480d2d6694982b38b04261321704e8f60fcdb42,python,26,22,4,4
NB_0490ea1a8e43d60c82a646f883a4c6243a5739191d4280b118bb6656cdaa635e,python,17,17,0,0
NB_5cea9aff3befed6d69313a567cbeb36d42f20861359cfe9918036944bbe0e566,python,3,3,0,0
NB_4665679ea4ef07d5814c9d2bb48c926665244a9e2701893ebb703f1e44cee03a,python,62,42,20,31
NB_9a45e00f603220e677c7acb2686f16aa62cb3cdc8b85205d35b32e43a171ceda,python,18,18,0,0
NB_643bab9d4fc12751fc2806760bb0d8ed005ad3cb6c690d750c05f76db4e33ded,python,59,27,32,87
NB_3d59d6390d09a703e859dc4be3c0a63bcce02f0cfd5a66f3c5d7c77a37cdc9c6,python,39,38,1,54
NB_655ade69cff2ecb144398f0c92686417adf4cb9c89e078f6d5bf24c8acc8f69e,python,15,15,0,0
NB_f540f57b49b7dbe1539bde93cc99c9a78c48dbda37cd2b6d7e78925e188d6555,python,15,7,8,37
NB_d9eeb6c1dfd79d4e6c18f69ad6ef545f81acf61b2e7db4c95a85e1d659028432,python,28,12,16,68
NB_e145d4f41a321c4b66bc52caa9c2cc548ed7c0b8209abcdb8c080c9926504574,python,78,65,13,13
NB_ff11b6214651cc6bf1c6a4dfa4fa025422c24fc11690aaeacbaab3fff2834060,python,53,17,36,473
NB_41b69cb8db93ec3d6e3066cc92304442aca17ade5b6475b4d75088d9fda63ded,python,109,86,23,27
NB_54d8dac7f8005dab8af339d98a5d2f28aa52a7da951cdc6369b6a2c211a6fcf9,others,23,12,11,11
NB_d0cc781d6e367e56233924b3714ed771196b796d15b9f456069a24e66d2e11cc,python,9,6,3,7
NB_764528d4090385a007d260a6f15c2d6b28fe865afa1a21c497eadf54e70ac6f8,python,33,33,0,0
NB_e04dcdb4f0c17aca6a2bf60212f2744a231a931667aceb78ac91e6e6d1b6260e,python,151,139,12,84
NB_9e65a5ba7f56ed6825a46f5b240ddaeded5a32bbce73a05dee50850e2f5b1448,python,87,67,20,28
NB_a73f8e4a4212d87b9af17ad53736c5adfbcaaf855a262e4f6930e46cf0427bfc,python,70,63,7,42
NB_f15f108d610ad6ea70a0a587ff7244cce9389ea96c171bca56e9b0995b985695,R,56,25,31,36
NB_eee58910770bcbd3d343b53983fdbfae97ec284882ea897ea00ddc884848ee6e,python,13,8,5,13
NB_524dbc4eebad1dd85ecca5fed33b71558cc55fd2aeb192036954b3b3ac2bc89c,python,30,30,0,0
NB_1ff7d8a2447a531b73f9e7d1460adcd370971a8559f8f14d66bf35205cf3c28d,python,6,6,0,0
NB_08f4c5ee63ad908d671c75792578fbdc06879efe95ada41168d82f8168cdab15,python,47,28,19,30
NB_bed1bf80b41dfb8e7c72c470c03203ed5ff363142173de66c6b95b2eec335739,others,12,11,1,1
NB_998ab166e9bed9116e87904f07ef5913f922f097dcae940c8e00a69530968d78,python,18,16,2,26
NB_fba88bef61287d1c7807571e17e58028e05892490a8c9f592927f57986d37a49,python,1,1,0,0
NB_5ebef9c599baa3b05424a81a0a35b6426bf9bb391e2e7bf2d98ca2c426cc72df,others,35,19,16,16
NB_60adecceb46555364c30c249a602f36e2bc2000530d06835f9ea09af3db0511d,python,13,7,6,51
NB_0c1b799ed82aa6cc125db06b3034c6db299bdd324041536394f952304d509f05,others,29,26,3,3
NB_ab9aa2aa23da6902ab273dda883dfbd652d1eada4caca5bf3b818c982cdc4cb7,python,10,10,0,0
NB_d89d28e6b5d8444c770b6c3fe02f4e6b7f901ec9ca140a86e771f5eb29acc1fa,python,56,48,8,8
NB_fed47e51eb203d9aa292ce7c3f23fd6ee8f7d5aac58286dcd63526cc61148c40,python,22,8,14,137
NB_bceaaa5097b0b27725b5702da6df0547ee8513ac3b55c3e44cd9c01453337549,python,30,30,0,0
NB_5f9c4cb59f077951fe53482441c19f1c88325cf12542dad23d848405a04ca3aa,python,29,24,5,7
NB_5b058bd699308f52f380392781ba47aad7ad3f7a3d3e847774f23e66badf39dd,python,14,10,4,14
NB_cc6e557d699b6a492e0d7d2af011d8644e6114a34f23f4a5703f7fc1876d2418,python,7,7,0,0
NB_21f719339081425679370e6041f5997ebad1eba8d72852f48a940605aa57021c,python,19,8,11,215
NB_b5f3ee9d49bc07757797091787fa58674536bb272ff50519ddc13ecd4bf23d65,python,45,35,10,16
NB_30b91da19a5f4038c8a21e0c192b58246ce8956d94abb36b42ca5dabddfe9acc,python,32,22,10,296
NB_1e0fb517be1307f5bbda2357bca6d52945ea40882848501282e9fac5310fdee2,python,4,4,0,0
NB_1c659216ac6a4796fada165bc94e1dafb85b62e78b54522ef68200e2c6ed6ea1,python,43,22,21,187
NB_da9b7d88c6710b2dbd0e007f6cdc3492eec40a478edbdfddc835dcf755c41613,python,41,41,0,0
NB_f7aad02df3dcf9a03426944a53ec417e1c820df502cd398141a41850322eeaa8,python,11,5,6,26
NB_78e95ee9a8867fbfc135f7787f7ebdf99eb2a6d23ba9c1f5c1702418e09cfc84,python,67,42,25,31
NB_f6f3db57f79ffe0e1bf078a5bbc1692e350cb80727a4ea2a0cfb8e4efdf3329b,python,31,24,7,12
NB_d79814a082be385abc375477190abe5d8c46e024154f6098f17eefb4b681eda1,python,21,8,13,18
NB_e9cedfef06443878076fb70c22e73543b78a3ebedd8a467298099197843eb0d7,python,44,17,27,954
NB_fcb4ef538331e5e1666d9be0aff2c825922c3d57c741834c8b28820fb4711f00,python,9,5,4,6
NB_1a83707fc1ea713b4afb901ab700b511d8e2abdca8f1c58c8ad862f4df736329,python,7,7,0,0
NB_9869be92e6f9d137dc536e6150d5e8cbc027247b13bc5f92a84eaff03b50fda0,python,24,13,11,37
NB_59d529c9e104e3dcfbb4fbcc98b8666e42e8212788d870df75210f96c2536b72,python,25,13,12,39
NB_f66ef4048b5e3958874d4e9f73de165c3462128b4a803021a690561fea99ca08,python,25,12,13,59
NB_17490d9af1ed64a60f93c734173bf13dc1d8b24b0a424ec6282558ad434a3c50,python,15,8,7,132
NB_d9b2d7ea0825d91aa3d67a2dca6b5c5e042888cf1c8a326a48662077d9682c13,python,9,4,5,21
NB_adb58996c0051144853c74518eef4621a7ea328ae027dac2644cf3a21c7de2b2,python,18,7,11,40
NB_1542c111311c9286fb198cc67336889387024893ad90093f41b84ff2f8453f82,python,47,19,28,559
NB_93faa59cb6a942f1d72ee70d82fb148de92393ce81ae6f908be9a1fefc3b62bb,python,43,25,18,27
NB_36eb19bb9f9c4b1b14bda3cca5eb5cd9125ad2ffee7b9adeffd65ec2365e6a37,python,15,15,0,0
NB_717e9a4e983e720d60790ed30256b09f789c1f6a7ff796348efe7795554d78e1,python,27,21,6,7
NB_478d362f37c99523b1345afe4535ea2560de2c5020f86a1251fbaa0a283ef2b2,python,22,13,9,110
NB_7999939b898b7b7a91a3a487829ee23897220d1c0679f0daa6999547ce6273ef,python,10,4,6,17
NB_58f9f30f19dfcd8250a8b17444153b1ce9c485930b4f338d3d40b0b4fa2d5c38,python,20,8,12,185
NB_5379f7835878b7f494e668f800a082ce4b1eb146f6ca607b3517a0ece21d0dbf,others,21,21,0,0
NB_da051f028bae5c09ea65f67fb423e5c79ab5fdb2e1585cf4e1f64d83209ef39c,python,78,44,34,129
NB_bd536e48bc6d92ddeb9458fbf4255cc999d4902e678f67a51c3d4ab88571135c,python,8,8,0,0
NB_c18cf7277f9d4cb8a158291e9b1d18d2efbcd2d8d9294067113534cb14917324,python,191,155,36,36
NB_5d2428e05d823a1d2ffcb99eca81351b7e1c51abd997a4c8a7775c2f9e24d2fa,python,25,25,0,0
NB_9cc28632cd4edf2da498c1f97ad5322ca4f19828c4479bda5110f18fc8c41287,others,42,41,1,1
NB_22545992fd43b47e63c985abb9b105876f38a8ebe8340f42c53061dc794df396,python,40,30,10,10
NB_945333429ae753b241784a69851e21dbefdfa50b3dba54dd682bee4d930dfe10,python,5,2,3,10
NB_7817eaee015bbd82a11f85e08bb91114cc376fbdb4ef5c18ddd505a003505b85,python,15,9,6,6
NB_ac3de3825e74d6cf9a3068bdb9a829dc4315606c54245ddb6addb6ed32f68451,python,17,8,9,10
NB_7ace6877a05183c09d376ade5220cfc2d48155aa87f6ed88539eda48922678a5,others,70,65,5,5
NB_995bf78572382d4dab42f8b9a4b515572890ebe2e9dd0baf24e3b91adab9bc48,python,7,3,4,17
NB_e8ff20bebf48d6801b80d98383ea75e025b22c79cd479a0ca54f57a042ed5820,python,27,13,14,59
NB_2e7afd60cb9a569413ad35aede82b0dc37b3cd7a280b1e82e771e4e410555341,python,68,29,39,75
NB_fde2d3b2764d7f911b0e811e3a5682c423a50cb81c39c053b0558532f7b9b7cd,python,40,24,16,41
NB_dca583251e242467429c0444b6f4a89730843133de47e548f68cb2b497b81539,python,49,28,21,245
NB_058562e8bcbd1e621076bda7490532e1eb926fb4c384e632df21f5a7a12d7e6f,python,23,10,13,32
NB_d2357e20b2dd866a80e3e338b11faa1cb9004c36220920b2e5276194f3512f2a,python,4,4,0,0
NB_4d914651b7e86e7f2ddb7bbad03a990a5f19d09665ff5151b14ad3f6b465eb9b,others,0,0,0,0
NB_30da4d117e53fc336cf7b24ad7c6872e34b8a4ae3a8467e2b715d0114f01f368,python,40,21,19,200
NB_cca87303c2e4cd3658419dc51047fee45fbaafbef07080b485bcf75acd5b04b5,python,13,13,0,0
NB_a23538b6d563f89cac33732d768d0a539cdba87af636dede1cb1ef3053b9dbe6,python,22,22,0,0
NB_0915414ad47f10913699a9c3a1248d683b739516e7c4e6100a67a8e37514d5c1,python,87,53,34,44
NB_1ccc3f68155f51a7d1a30f8d73baa6d14913d0d0ae368a1bc66df88f98cfd660,python,89,64,25,77
NB_88b46e8df21aea7463fbdce317f23c5f1d2bb20c81c73180d87e6752f11069b6,python,44,23,21,150
NB_0f48e54421925b65e216c3e21d4bf24ae03aab7500b7964a16ed64a12412734c,python,84,58,26,233
NB_03529e73b69987275f5afc5184b71fac58361f33f1d4a952bf4006040f5dfc0e,python,15,9,6,49
NB_50890ac7835af80b978aca6b400976e61510dfdaadaf3ee7f1f747edf8f711fa,python,11,4,7,61
NB_af4d6194eed4f6d0f1aaec94d5ece042285746875974db3973937e99c9812f24,python,5,4,1,7
NB_46b50db3c97f5f39c9d744b9a129a441b51834c00c4bbc7ecad5dfe4a7e649a2,python,6,3,3,7
NB_ecae1e50ac79e6b3063512d37bbd0b0fa20acee7c4831b75e3bb3d46172d6466,python,192,190,2,2
NB_a2c1fe2f2efc0e232df7ab5f2589080d5868859eed85fb65075e2abf113e3041,python,8,7,1,1
NB_534856d7bd2db557675dc13fe8096feee89415ce4ba4b5c1ebfb77a1044fa92e,python,43,39,4,4
NB_bc3257f44f708eb0145eff0bf9513ddcbc2ea10ea8874bb3df9dc8d0ece47e6a,python,12,12,0,0
NB_b65c4d5b6fab0b8b06e3d29d6da69120fb8284a0e0b23a5d10f140f7de74e27e,python,76,62,14,14
NB_d042cbd49255523785297012cd77b09a70159ff573fa00ae6f3f7b827938b579,python,34,13,21,42
NB_06571b09f2d2efcf8c2fdda560f97a1b1a29f4afc0639a73aad2c45a2ead3fb5,python,48,33,15,22
NB_3a98ab20643f8ccf6a91cfc22b39d84d403d0e9baa7cfbf425c983652fcae555,python,3,3,0,0
NB_aad4ecb18913d700be6bc4a280984af1a8d27ffe353456af90e469f9ad2ba594,python,2,1,1,19
NB_f60478eca2e510274fe2f7aa740418190843ff0f332cc5343359b86fb2d45cb1,python,11,11,0,0
NB_456af223fa41e3943946b40ec49fa0721df3522f5fe4714e632d48845688c2d4,python,26,12,14,53
NB_d5b113bd34da49c9e926a901761a5a277b23dd7df0aafe642ec64fe975298483,python,22,12,10,61
NB_9ce09fe990ed9a998cb10b2df4e8991b03c33aed3bef8a137d27ad5c15994a69,python,12,3,9,77
NB_1bbfc7a9130ce7d4819bccf273742f0052d15361bdf2271d5567c6b9a27561c3,others,28,25,3,3
NB_77431724be96e3de7e5c50aea48de158c0251f515dd860e9e3328d067d375122,python,7,7,0,0
NB_95151e1e53f2321eff52f1960a7dba24340c4297d0eff6a6a4085ed81c0e4798,python,14,5,9,83
NB_5ffa9ba84bd5fe988c743f50e9f8e3216aef089f705bc9da6f87ff818c4ec0fc,python,11,11,0,0
NB_c6bbfdf1e3867649f1b2141de672bd7efd3f3c101fe95204c10fb01dd5a0f6f1,python,18,12,6,6
NB_5f527a914e42e2fcf2eee65c3318ee893378b3d9616075413ad50de805fe8f14,python,46,35,11,11
NB_49a0049dd159d649726c9a6ebf1eccdd93fe2110aedcf4ed895fef1e555956e9,R,56,35,21,38
NB_74aeb022c95e8c94c79ac24b82c166e8f9b40f8aaf84a9a41b4feabf2c1aa712,python,12,5,7,19
NB_2f68d16e30dc90e301f7511371216bf11f91119a3324f5513de7aa02b265ce7c,python,26,15,11,13
NB_c289e2a17f0595528b5460488b38c5721df2bc518bbe3399a08ba19e0c1fa134,python,2,1,1,299
NB_66111e7891ab7f49638ea033a2a08b416895fc463ea97b760500bc46f3766315,python,20,8,12,80
NB_919b4a9e291db100384e58456d1a185777fe902778382bd323ff2e70a8f8d547,python,42,12,30,37
NB_76e9cbe58cc2c3f8884275b58b09f2ab4d5e1ee291722cfd0273a409a6932dd0,python,12,7,5,56
NB_ebdb46a9dced30f12f5c94cd559c2d4a348d066ef2ad53755fab8268da4c441e,python,2,2,0,0
NB_5691b5f8fefdc9228103c2e79b9d373f2bf0f9af25caf3729c0f74755e287071,python,35,24,11,13
NB_dca92895532543cc26189d2f4e3828da72da1725a8f17acf936c1050e41f8659,python,71,31,40,450
NB_00e1c822568f2e91bae345c69c01700ba68ac7592e4c34bf3546aeec21be9c53,python,7,3,4,6
NB_279204c123a47887e514622cd7c70cf21b5f981f31aa2fb5e315df61ab0996aa,python,32,15,17,199
NB_441db50a69f1fdc9a3c91ba2c4abcaccce05ab640bd6f14f648ed2ded7d159a1,python,8,3,5,5
NB_73c45e4fd0ba792b41da74687874088b8a8034a7dfb33352a4c305b73d19818b,python,24,24,0,0
NB_046dcb6953444cb7730513a55d9f448825e31851a8f41708f7dd61fb3174603b,python,118,69,49,145
NB_4f1bd34247b4ac2ea9077814033a133dd46694ce99f01997782291a5a45a15ed,python,10,5,5,5
NB_729ffb7f3a6acc74c5b055c831b97004a6e803a283caeb4f44d5f2230cf4397a,python,6,6,0,0
NB_323318d9883698b661b730f8488322aaec77673a8a1c599f94eab67b1ee43e59,python,56,23,33,208
NB_8279de4effee858980ad792d3ab8d5d0bb0013af84b70fadbada896ab94f8e56,python,338,252,86,205
NB_94e95d0b5f6d5ab1117dd26aa9aa216a4c08c8ef46512fa365076c2263b35041,python,67,54,13,13
NB_134e43159516fe666932690b9284054761145cf7cda7fe92658ed5b701200bf5,python,16,16,0,0
NB_270f191c27aeaa70011ecb9112f9a5f461ba8296e8778fa178d9d1ff9065ed63,R,15,8,7,17
NB_575137a1ece13b178788e991770e92b013c7801c236149a244d7d55e9ccb7ea2,python,9,8,1,1
NB_3ce6e438527c7cf63394cccd9a21be801922433ee54f766678b992669e24b7c8,python,28,12,16,259
NB_eb73ac0ce068005c71e8ff6b7717077c954bbbf34ebf31d4d4dd5f9f007bc900,python,32,32,0,0
NB_1d2b2d75c9722fa8122cddf23c6ba27e75e70f15ee789021f42613364fe9a20a,python,33,33,0,0
NB_0b7679347d915da4e2fe7951e433f1e6a23d9da1c4870b6dfe074c5bde0b2768,python,34,34,0,0
NB_cfc2f14a89adeaf5b9c2bb4654980b8134bbf5b225d6371817d8e53bf2c8e3a9,python,75,31,44,263
NB_9b42cf7c09c82b0fa2c60eb0d81a975ad6a195b778e5f416960c69ecfa98ef43,python,40,26,14,75
NB_eceafbcf8c5c3c1161a9110199fc678e34089496ef5cca9105a79695093a5a53,python,17,10,7,48
NB_abbfb49889b13569e5b432120b0ececa0836dc5cb04482e7ae2f29249177b396,python,23,19,4,26
NB_02151f6fa03158c4de7d88e061aeeece882589cbe145b9f5033350e6bf3ece87,python,5,5,0,0
NB_4ad5df672a9b64cf5d34933ce8f65b627795bc8bd0ea15fefbd83a32b51b76f6,python,41,12,29,259
NB_d800a200f6ae99bd7193794d7e2a1522b0bfeaee696355a0b35e24f5154e4e69,python,8,8,0,0
NB_cbdb14cec179026c8861df5cf968aeab63e05cbbd5d18e26b0f8143119721c46,python,74,74,0,0
NB_4c6791e01b8ad060dbd0a6a4b945edb1eac548a4f4ad3dc9f0b8a3b42d6a526d,python,25,25,0,0
NB_650693c001494223e367d68210c664fdbdeaef4d67bf51dbb44b21eef0e8983a,python,18,16,2,2
NB_b166bc777ab360680674c392ecb50a3cd8ac784c24a6667c0a2890315e7a3321,others,86,75,11,59
NB_1dcb8a50d69a6b81bcee000a120696cae98e4fb6ba453610950c23c9f01c568b,python,27,5,22,145
NB_63cefb072990dc065df8e112936b4370af5be708d03278b8623b0cfa30a0152e,python,27,23,4,6
NB_8fe280a0fef73b253ba225aed2e863c094d75e03d52cfcb9f7827780750247cc,python,22,11,11,33
NB_02d59d48e5d9e42c801e46747b03903b43ed9d19d5ca780fed76e941e98e0ea9,python,11,10,1,21
NB_608b8fb32b61d13f1a206025eabf1d935727f7b4a5a29b8b08db64d083ba3c00,R,68,29,39,98
NB_1b948d957c8e703ff0afeabf9e2e72f331727a768b36a1035b60325a9162e901,python,98,92,6,6
NB_8313486e39e48ac123db2302075c152ce7dd7950e6937e23f0d1551572d9dff9,python,14,14,0,0
NB_ca758709b14a9d2dcae81547ecedef3f9c79281d44b3b10ae16d6cccee6be750,python,20,16,4,4
NB_fc3b00a12b6eee01475c7ae7a92cf141ed869846383352ded0db40a462692d4a,python,39,25,14,14
NB_a2fc7ab8949cd1946393448ed5ecfa3a6c61e80e967dd2a673ff011f752b1423,python,17,8,9,49
NB_32b3f49a4edbcf609ea90d4bcf23194dc3c8faf7d07bf5c0d919d39991a5507a,others,8,7,1,1
NB_0eb99c1666a39a0c4ecaa8521e9b58d95d4141dd49bfecffa19ff7b70acd45e1,python,8,8,0,0
NB_1af53fcbd3a5e41eda5a6a527ed20b962916fd8ebfb130e08421fce6bd959653,python,47,31,16,54
NB_fa6cc2d862f2e3d7872c753d305e80194fedec2b03028a0a06932c78cb3e907e,python,41,41,0,0
NB_152fc25d90dc9d29a75edf0996b35beac8c1b3e2679a30df9a0fbad7210e4ea7,python,4,4,0,0
NB_28cdb12be4947dbf0a193c99b94d9ee72f48aba9e8d5b3ee4f1c6d87e1fc78bc,python,20,14,6,14
NB_adc0b6ef59679fe483aacf66bd1e41c7a16333427e73abb49c126c59cec98afc,python,19,13,6,17
NB_ab2cd2e7ab7d92d9662de1d5068af7f011d13022c02329e3b3c91568eeafb743,python,12,12,0,0
NB_a162f18bbdcc716166dde08d6cc8c48759348f581cbfead727f3081c5b97ed0f,python,32,32,0,0
NB_e434fc41d1c13330d72128f6e151f91b688bb57cac7b1d0f7b415fc91c501c1f,python,106,85,21,21
NB_4b3726fdfeec04e26aafdb19aa060b0310d5cf27f8f10c355b93ebb0d3dc9389,python,4,4,0,0
NB_771f1ef10abb05401d338178b146d5cce6fa66c97b4643e5105b4a9ee4e1375c,python,36,22,14,21
NB_efb8015a09506b1a10f20c6cbcdd6e0114e212c042fe5b60c19f25342422faab,python,24,23,1,1
NB_a080c6120b344aa173ded6035301db451964419105552817641e0cb169d27af4,python,13,12,1,1
NB_3a13618599a674c1da0c76a9df5dc602e00821f73decfe21773bc3cafe274d9c,python,1,1,0,0
NB_52a0bb4d27f366a48e5e9e7b7c5fe68cafeba6ce01f1fdd98f7c38bb1a59182b,others,78,45,33,37
NB_c9ee52070048d99ab1145fc8e1e79a6947b84f74315a7fe26467f62b2fa8c8b6,python,44,17,27,954
NB_562f7260d34708a121af9720bd36f415c1647fafa402537bcae7109b2aeb7e25,python,8,7,1,5
NB_47e810896eb1d32feb737b7bb81e3748c62981a227e35eee6a99c22e59e14b64,python,63,43,20,34
NB_daa939c3f87bddcfd6c83053bfeeb76f4d70f0f31a48a4ab16603c0ee460e5f2,python,19,8,11,81
NB_15333667829e7eb6731bc10585d05662601b5a9f4a95fe0370e93b56d55677bf,python,45,35,10,10
NB_21b102510ac63819e0e17a92821d881f6a6158219037a3ccb4fd7f109bf0fbd2,python,1264,804,460,628
NB_02eb247851dde26a851b57e05e559af24ad4c950783eac135478fb97282d13f4,python,10,10,0,0
NB_7cb9c9f60e99eb0953973f051c9bdd0f1a20061322982092a38190f7fadf37cb,python,100,81,19,57
NB_928efc8cb6efdf1d1e520ce411f1b4b22a78f3d6c7640f6bc1dc1e007b0260b7,python,28,17,11,11
NB_6fc139b11455fcc976bf3ab476d5c054d0e2dd6b3ee7f22f96a59cf770dba4e5,python,17,17,0,0
NB_55f4e55fd61114a30015d3ef0af4b99480431b776067a3dcde0bc8790a5b08e0,others,32,27,5,5
NB_27474654603d4b367f570eb2a2302267ff1e6a44b655ab58e79affda963a79a4,python,86,64,22,23
NB_aac1e11b1d4e9dc467a31d54cf8c27eec40644a063f9e58f83bfa38b38ca5a0d,python,41,41,0,0
NB_de56d5bc50d3eb6738b2ff025f278dad6fa86e43a188c1e3b0dc79890bec1543,python,16,11,5,5
NB_f975c1090b80a61530d7602052363fa785f26c58741ccb340b90e01865cf51ec,python,23,10,13,32
NB_fc01c2a0247cf8151063b2c771a0fc357a44f8c3d300c4b9efac35418c765c83,python,5,4,1,5
NB_25de3b06f2440d37801ad6e1eff3af8183339a2e88d0c400e9b8b3ad83325937,python,29,28,1,1
NB_a50c961a780520823d132f63f804645d4fd309c36b6d1edec65e995210e05374,python,46,42,4,6
NB_b3b8b7e3d10aa1d385fd7efeb1743c73d3b5b349f2275c094e9d0823a549b792,python,53,21,32,542
NB_03acef180a569664e798eb7e63fc71ee87675a2318b523281b5be92a32d80130,python,37,19,18,148
NB_2d8f8fa0ad5fc2b518534ce45e853c1a1a0f4d9b15ed44f1fbd2a3cedc3c8550,python,55,25,30,44
NB_7e48d3301e4966fe3484261fce8ed429a666ae9e9b897bdec86a93061077355e,python,31,15,16,301
NB_324bdbe8801bd995e725e6e4ede2d599ff1bbf42bfc52e0268252e341bc2a621,python,26,23,3,3
NB_db6a2a8c9d065bb5b2ac04e111a5823643215db30dd52fa6e341b50c29a80022,python,4,4,0,0
NB_d59813c9a5402a2d384027632b6a05360186465845d8c3b2ed4123b77b587e88,python,31,14,17,31
NB_ef208acc6286738919a9f1a03e1442c30f0278efc584c8dc6f207b2a78832dae,julia,5,5,0,0
NB_9549305cbfb8731cc36f2c821ee6cd44b32be923c121dbbb061c33c13696f4f6,python,22,11,11,19
NB_b2219bf8a5128ce0609c69ac685b794857e18571166470e2619eb4d33fdc623b,python,18,9,9,176
NB_5d4bcad2e8e8e2394b8e7ab0d1d8e101909fe371550bbb57af73f6d7486b9b7c,python,15,8,7,27
NB_9385a226a6a75b3d2b02a3d1667b690d1fb2370fe887f683e14ab40c3032d4e3,python,17,14,3,3
NB_767d0e04881c22809cc5c80a9e33b283fc37f8d5b303f3e5f7c08ce416f8d1c6,python,234,82,152,218
NB_0b324c96f5715289af5eaf11ebc4eff10db32d2fed792cc29da13d4a67d4d7fb,python,11,7,4,25
NB_9a2e2ad9994b654fff339698e92442aa6d610f2c7cbb2f2b89c32d3432041aaf,others,51,40,11,22
NB_9ea033cc414973f947dae719b43fc0bc4e92a7f3cafaabae0c0eed31b4a0a6de,python,28,9,19,53
NB_62bd16f66e61b3a2a23075cf94f2939b677d9cca88b5f213d3fc3973911f9220,python,1,1,0,0
NB_b2b2691e094f5e5a8da1fe8f1349aad0dc53f341b92bf7187b9db0d18a91acd0,python,40,37,3,3
NB_4c29e727937cdccf39fd37bea1e123c9db19cc063f87ba1c903dc1f8b364cb9a,python,20,20,0,0
NB_c981b882cc8d7f232afb350d0b6d4bad2a52590d5a80cd3823a1c5a549ac3d84,python,19,9,10,30
NB_10d3a9cc2fda7b90691c7edb5c4763fbc6f765b29db3d2c27dba113bc8fd4013,python,45,30,15,28
NB_b9f44e55b05dd23d641b264b7ef0eba0c3248d08b5bc6c95e08ef7b989bab0f7,julia,8,8,0,0
NB_484c12e17611536940e8e4c544ac188bd10e50d50b7a1a1c08fb5b1b76e27b0f,python,33,16,17,106
NB_a4025386b640c07c7080db9bf366c8b6c6b0a8c10840fca8fdb2fc71857e0410,python,16,12,4,4
NB_48b5c9b825c519080b832da55ec6c9c4f653bc8cd9c15173177613e59ad20133,python,2,2,0,0
NB_cd47cfcea857b824f3102d98c1974a3732e83e973154d445a6eb63a2a0bc8f54,python,7,3,4,8
NB_aaf932e3f9692af20f7fbb4cc6ddf82e0f1f42d9b295c7db7457e59c88698caf,python,46,17,29,263
NB_6cedcce48d22764b3e1f57bafb6b153cf42a7feb56a9503ce45dd71364b13899,python,6,6,0,0
NB_dc3eb7a782262d8b20828290000388cd9cf30da231ee4fda0614e62b514a88c7,python,29,18,11,76
NB_0343689b86a5d8b7d3fdc279c2a2a612315e55ed6b58e4ca1a4a1d123bd2dcee,python,26,13,13,71
NB_d7c19e646ced79d4ff124565248e003ef34e3624827d106fdef48938d9b3d9d5,python,25,14,11,101
NB_9e56425628ef0193595fdb6d5781cb3bad371496598aeeb825d9c5df23e7df0e,python,20,20,0,0
NB_948b5dcf11ee197c69d48a86f9b96e283bb75afb8eccfb640f528201cf94ee1a,python,86,56,30,120
NB_9d32492b218bd4d51b30949c617e3fd5b065c1af364c7c923a85b38a886ff020,python,47,26,21,29
NB_fad7b347a9893e7926d325a65ebafd1509577d972ab8beed2debf323beffe3b7,others,78,45,33,37
NB_0285e823cf201fb3e23b11c5e754ce43b413e5ce3e642cbd77ade6364012766e,python,67,40,27,209
NB_090fa36e5b37ccea3b9e058797a14cbce2cbbafe512ad7ec9fec66c873fd1e2c,python,26,22,4,16
NB_8dc5ab335ad1a96a071e674e506895677b35de3810ed4a741ff24c6f1fcb15d9,others,34,31,3,3
NB_34d02c6a57d3fecffb67a34d5e1118e5b7a3576d11369a29f58e779d0dcfc3ce,python,10,4,6,82
NB_eee5c3844968184efa665475a5ccb0152909177504dc478ce888309bcad9ad55,python,5,4,1,1
NB_993334b5a76cba3909186df0394257d430956cde0bc083094624e5db9bbaa4fc,python,30,18,12,32
NB_792af898719ed0ec8285f6c55bb634b47ecfe2310cc0c78ebae26bd0b8b2ff43,python,14,10,4,4
NB_39bf5a44dc1b2a094427f30a500ac79ccfd094df24a928691e62ff17851d6338,python,29,22,7,65
NB_38175eb78b1904355afe5f54260f8b97e4482145a5c97f4861241f3072acdd93,python,18,12,6,37
NB_f7bf0d160bd6fd3fc0e6049ad2f4038b0f26ec7b87373d6a0f0c11bb0c3e94df,python,53,29,24,63
NB_d2bcb538cfdf458a69c0c0362f7756dfb5fa8d94f53f1c1c2568aedbc94c45c2,python,18,18,0,0
NB_244a96d5d039e7a6ba7a9d1d26af6b9d937a71bfcfdb1f0a141434d3c5b503c9,python,47,21,26,54
NB_2e0e190ffd98bade07ad0866bdecbcc23b2df5ba0ad712924f953245b4681afb,python,17,11,6,18
NB_30807b37d6253888f09c1774551568a8e125089d0d9e8288344dbc16bf9683cb,python,13,13,0,0
NB_b081bf1d884ff4bf2b2dec07616c050645d0cd747eccdd0cd66572975017ee20,python,33,19,14,128
NB_13934755c53d8953db082df51fa05aa33ecd1b3b027eb58aaaca0b91124c1d0c,python,66,52,14,36
NB_82a42ace32bbdf737dc2a5d17a4c54f0a9d66f7f1e61035a9b6f3014190f3cbf,python,15,11,4,37
NB_52c455193d4bbd064c55ddbb6d027d60d7a41c80f601a05a82906ff7100e2023,python,14,8,6,14
NB_6833bbf849d349b71a53ee76b92a2082b0020bf6e4060ade41ba5d876109bc69,python,7,3,4,4
NB_42e8aa8c1f7e852bb6c57ceb93198c64d1730a0d73f33b4d2e9da87b373931d3,python,12,7,5,56
NB_64c50e45d345e55450a9aa859e477e78c74b53f62462f1c60dce95b72ee53578,python,95,78,17,17
NB_b2c010b621f25cd71269f4bab76b724cf36c1fff4634569ff898be8c5cfe1f04,python,41,19,22,316
NB_54e008553b3d806fa72d8f71ad483335caaa7eb3663d1062e55e2c4c00846a1b,python,20,20,0,0
NB_390a61dddadbe584f1b644d3ea409d5e0913dfed20a03b1bd56bbc391e62555a,python,34,34,0,0
NB_ea8d37c0e5ff08e0d883f984cf2ed8a895500de60102e3afc7892087f5e5885a,python,35,13,22,252
NB_7fd737a9fce4dfc38ea16d4bc3a56d00c1bd2ed9b57872af70a2448c6a5471e8,python,19,9,10,16
NB_c98f0cbf96cba3f96a97440ffbc998fb0349d733f7ab60be6eb733a77a346cd0,python,7,7,0,0
NB_9d485777d6c3b78e9f2106ce3c26d03638e5d421e3daf3b74bedb9931b1f3a6a,python,4,3,1,1
NB_d8e54bbabfc9a454db06ca90a9cdaebddabe43ad6d433ce99ac786fbc230bffa,python,60,51,9,9
NB_9b7861d11e0a593eee2d18d050c1366a42bab5ea9c8cb0a5c31433fbefa6c61d,python,41,14,27,89
NB_a7be63a750df39ef9fd81c1063dce45d27a10d3ce600d79b8e7fce6e2d8f8638,python,70,29,41,410
NB_97a54bafbdfd819125e46e3ecaa6b30419d6d0accbc4dac4adcb3d40e037c9a5,python,7,6,1,9
NB_c040ff6fd36d4e3da8c60f3f744f9ba0564a7b77a76677bc4dd87c802fd4c116,python,42,15,27,112
NB_110be9e9a440ce2b8861e86b58a6d080e626b571b6b0ffeac0bdb9885f7680cb,python,27,18,9,10
NB_15837c1ed025781c3297ee1e45d642859b73f2a61a09c4058311d8b04c88b98d,R,55,32,23,206
NB_652ffdcd8203e2c64507b9f919be421499295bb19b85b7ff5847c262204cd20c,python,36,35,1,1
NB_70afd71310cf1e900c8d27b90f6fc8305a96d9575e8d88372b12ab56d2b43f43,python,9,5,4,4
NB_88531da32b2853fc8c4c6d43f30bf6faab194a4bc282e8fa86d3c0b9dc080e37,python,15,10,5,13
NB_e804ab2b9e921a708b6cc16c8f78c598f6273110ef00003fe11603b56fa18fc5,others,56,55,1,2
NB_8d2e89dc0800af72c270cb3ef83b5befd44c1e370b9e565281081d8fd6d55da9,others,121,75,46,172
NB_4b8c358bf43cf104f9e50b9c074b602ab374b6312c22e0e306b4157fe8f418f3,python,21,11,10,48
NB_4428610e5d564a26353806f2731f81e231cec3770c556f88cb6e63418b0acf17,python,3,2,1,3
NB_61bf412622ee9684abc10dbd68b2deb79b5f3bff35c412dcdebe76e01e751413,python,19,9,10,57
NB_16051bf00547c6d378424aa5374ef55f86f3bb21fe48dba2d843d960e39cdaad,python,9,5,4,4
NB_dcf51620d46616ed8bc256daad37688ab76237275c99d5de154a35c9a64e0949,python,13,7,6,48
NB_0062de4bffaf2240d124457c86464209cb54b8259469bf444ce217c4e2231d1b,python,18,9,9,51
NB_b9acc74b0ffc621558aa4ee5600c1234c41312d66f2d3d8fbfe9535033795a43,python,14,13,1,3
NB_e5d0958feb288a9d0b159508b151c2dfd36e5db700ab7df225814208b2bf9d49,python,6,6,0,0
NB_d9175b6199d241fe4e84b90d7de6a76d3bb317a3a705c21b004c1e9f800709fe,python,514,394,120,127
NB_43ab1571b03ec56586b97f672458b9afee0e40312a93d41ed26b97c1accb3268,others,75,42,33,39
NB_f1f0db9403f5de61fbdb76fdf90acfa7365b99d3efd8f51d27d14104dae4013c,python,27,13,14,65
NB_2b7063356a84aeb8ef307621173ea48a7359400d14d031ae552f3854e25e4662,python,79,79,0,0
NB_471657a7b8934b93b7d59e399cc02340efff6b7bbc9df9d579dafb5e13dba875,python,34,25,9,9
NB_8dc2634b60133a31acc16684fbbffcd60f5e867b1dd34d32f262b0332d68f034,python,43,26,17,110
NB_af3cdbdc7b70dd450f668bc612ab33c4d65b74f3e2c6f5e772ab80c18f3787dc,python,57,43,14,15
NB_7757167f1619febc30fc3d84219029d5092e3da281a0202c6e212491ad8208e0,others,39,39,0,0
NB_b03fba8f7373b9b4bbb35b0c12deca0860f5ffeece4c99106bcb7973c2b11b56,python,15,10,5,11
NB_71ab71d17555480652a897ae6b8d3c464a44517d7e16bb0049fb779d5c908b32,python,37,35,2,8
NB_ba2dc9c987c58ded6bd25da1aac077e798bca23d7c9bf8bb473e1ed92982892b,python,33,19,14,128
NB_4978150097bcda31fa3e3a2e9c687c82e5ffff94ad6ac9a4b74782779ea419ce,others,0,0,0,0
NB_4d4c940e011c1a176ebca0d49116e4486a3362e48e060487dc6bb4cacae53eb6,python,15,14,1,1
NB_cb957048e9162fd7d403f1f863bbbd77e9536e9ff965eff340603b2f5fa1655a,others,38,34,4,4
NB_163315ce708c5a695e0d024f92f2e3f876fe123c082e21b2a47bd6900c2df608,others,78,45,33,37
NB_48e25e5462f0b82afde1001c4e8a1bacaf66ff5d9c53f9543a07ad0b0cfaac31,python,12,5,7,8
NB_41d35bfd86198ebc95636673d1107c791404b667a57cd5dbdd6b81e7fdf42b40,python,24,10,14,106
NB_ea88ca54cac2f95558a28d0acbfc8395a9d5963772c1736701325de09b0e776c,python,12,12,0,0
NB_376bff0682af960e5cd00f7106fc5b2ea1a0ddac952c68de5ee420dfec36b6ec,python,10,5,5,30
NB_4cef01e1d95b9d669a83b4f1b42303e15d793bbca82302e2a132bc3b4d5da817,python,13,6,7,13
NB_97062e621243bedf7b8a860fd1e44cc4880be3fc038e93cc76aef5a872706fe2,python,14,7,7,18
NB_5822603da985119fe2be4526ba7b86ee8d1b97f9a077f55a46e5733bcdd63fa1,python,10,5,5,5
NB_39bf7d7f7ba086476c5a464c4f79d5ae20640c800defba1f097fda5a58eddbec,python,60,53,7,7
NB_02183105b49a553b5a77383493e13adb82279ddad378334d381b8e377e190e94,python,31,19,12,25
NB_ca4ff69f3fa989981338d0e318ae96c874c35284859ec218c95c896e3f57a8e5,python,26,14,12,108
NB_7d7a2a396136eb630a04690ce2779a78d049d851cee7857e9ccc4b79ae67347e,python,38,19,19,245
NB_057d55486ba8f71071a503704e889d02e78f3e94c085b263471ff23af5d1b681,python,13,12,1,1
NB_53487aeebf42a7c08caf8c4ae29ff826435e0277d746988314c2e8d033466765,python,69,63,6,8
NB_7367da1ebddabbb530ead24f12d1fe6754979d7c2cdee41b163350508c5d2356,python,2,1,1,1
NB_2aaa779bb8b6e66047a63c79c35277ae8402af5c23c36de13007b65667321aa1,python,16,16,0,0
NB_46bbe9361b92a091d8052dc93f9effa6f11aa91c49a25392fb1936af2cf138fa,python,25,14,11,74
NB_2931b156c2a1942133ffb018cc621c4214a6e01cf5456f490d0e49c4f5f94911,python,8,5,3,34
NB_6b4eaf76b62c4305d793a1774667beef04e95ad36c44a3e1ffe30092eeeb1545,python,16,11,5,7
NB_e5753375cdcd91cccf1df2fe8a897f4c99434599f93b9260ba321cd415586a2b,others,78,45,33,37
NB_c82ceba728e425f0b63d0915b045ce55ccc56633bdbe3c20b9720a5f9e8eebfc,python,38,16,22,240
NB_af66831f70f869e3fc6ceedaefbdb6dac3a9e90e583b7cdc5bcae19817d731ee,python,3,2,1,55
NB_a6ab915df260f1cfa194c7d957de5a1c52713a88dc4ff5393d1657c53f6d9497,python,8,8,0,0
NB_ac1df4ed746b87a1f4689d8715f2dd4525fb5c0474ba190f30dcd913f4c0b7b6,python,11,8,3,5
NB_df823a5ef2871db8f3120710c08e7f3d95e88e3da8d10e97d2930f8d030c2e2c,python,9,9,0,0
NB_cbd0143b347ae5d721e2d47728427d1e84e1ac835ee08a2bb6825d95a15f43f7,python,15,11,4,4
NB_aa475314be04caf8cbcdef300f4fb9e69aa81d4925a380f824b2baea3f33e739,python,16,7,9,131
NB_231105ef651407a212052750fc11ecbc4fe2a9048d48549d6efb2716c8ef8c0a,python,57,36,21,21
NB_3ae8d563c16aa24d5da70687ef2acfb8e6741c316483397d974421a66ff129ea,python,66,43,23,30
NB_6c63a394464e1891c4f0661644941c7e9f1617873d9792f3ac0adaccdb0054d1,python,87,54,33,95
NB_694c24c1518bea9293c54b90ded6b3d60b223532feacb6b9ee4e9c2abfadd88a,python,15,11,4,8
NB_7bfa791ea8c3a0446a5d4d7e30b58684de84218df9b44b4833d42cc685f53a06,python,18,8,10,138
NB_99f044f61002e73f852d2b0b96c8c689ff6c32439c1de37c783cef5d14e2fd67,python,8,8,0,0
NB_b2d1c311092b880ac5db2bae04bb69173331be3bc96f6388b7b8fd0b8863e083,python,22,13,9,19
NB_27bce7faebaafb181696a9334be3ee29b8adfa7e848a874b97e4baad000e077d,python,16,10,6,18
NB_be74b8acb70a34cc8df34c36198b66bcbba381f47c29216a5e22a118365b4f63,python,11,11,0,0
NB_aa40e9ee1c7499c88effee62ee27d29f6f1ca219ea415f38c4f4f591baadf931,python,28,12,16,25
NB_e0848247d03a2dd0618a2a3633063204a767542781589d5c4ed3f0ef36ad19e7,python,24,21,3,7
NB_d6f7a0f763a7cdd63647a1e75e7f43ca2fb1ed6bc8bac6f17ea090efbcec27c9,python,20,14,6,14
NB_49cc5b0e6c126657255c31905bde35bb34e54b4d9c1db9d022244df100400eb6,python,17,1,16,388
NB_e822eb22e7aa5e6da3ce166b80419031388f2fb86f120c93eb39e3fddf1d0254,python,25,11,14,20
NB_9cdac0c14eddf43043ec5c7c70587adc8f2a17ee15e67090f85b8a8fe7dd9931,others,52,30,22,23
NB_13def676d9de1a2100df291287992fbb845b7805ae6c98b896e565627143d7cb,others,16,15,1,1
NB_2e7cc1348a02fcb62c5513780283d46360547a826207fa84bae11727ae329e96,python,1,1,0,0
NB_559ef922bda95578952ebcfa59a96aecfb407c6033a56101c1eabfdec150070a,python,19,17,2,29
NB_3fd882955baec034e7b521c5ce529fce81fd6d8a0f43c786153b9f62b0054bf0,python,13,6,7,12
NB_ac806f9e3583d14367c9544aad6d66d660166b3a41d126886eeb2b4b4cfc60aa,python,31,24,7,8
NB_9206e08690c3e0243c267889fbe1ac40b8dc62e9044b1132bc4b1a2c2df8833c,python,39,39,0,0
NB_8fbe6a8b7d175786b987429e56e64daf9ab7bf7ece0273f563b957e135e18596,python,1,1,0,0
NB_9df62ccfc11a7f4f5bfb80f3456fd7b627e18e3158d7a5c3b70ee8aa3cd28f23,others,93,56,37,37
NB_47e21b4debd221bd17b854a42d9faca278580c31cfd087d9f9016ad6f7b6c8db,python,14,6,8,139
NB_447416fddc45c232b595037de96b100d617c50be049f1e8c5ae252d82e9899c4,python,26,19,7,16
NB_031590ab3f9e2468bbabcebb192f86a99a1bbcf7883c34fbab7bb44b3b90417c,python,8,8,0,0
NB_8e0af974a3f5328f60a97756d7224c0a10f1b0d2a946c17f9e86daccdfc3c2a4,python,21,12,9,97
NB_8b25e8b592c515094ba0a778352568257bedba563de675409bc520c714fb5452,python,9,9,0,0
NB_d386a7790f897dfda273e1121be5f253908614d440c88f3fb616407a73035f07,python,21,10,11,92
NB_27e444be227c3699e23d4da900f24a3b70bdc6606cd65b1a548a667c290ae907,python,24,10,14,228
NB_3202b6f91d1a1981c7907c5f02389ace1070542da6a278dcf1513bcf6ec646f6,python,27,27,0,0
NB_d2cd8967b79be3f1b713697e878330253dedce03fc72749c1e8e2a7b917401b5,python,10,5,5,5
NB_277e8e317cabed32abd64a7e6a7d625ae8da0f89b01a647a1110b2455a624fd5,python,89,38,51,69
NB_bd081c20f00a1d832a5e44a0b3f8f95fbec309cfc82e0ebe4b8872322012dcd5,python,69,32,37,153
NB_6820fd221a3a86f723062d22d41892483c797330df3afcbbc3e51f642be7586f,python,3,2,1,1
NB_835b5aa28c7f23ead6e542d08fa3d63760873b28bf2e6988b465cacc5efa4565,python,22,21,1,1
NB_42e221284c2f06bc51b068918bebe29a089b54145052bfd3f4fa658f4067dd42,others,65,47,18,39
NB_2d19863e21551d8611e22745548cfeab5fab78facb6b1903287740df97dce86c,python,53,48,5,5
NB_78faee2855cc6258c3bb01ab9b82d8c8f36f944966c4c9d30dd850f56c0f9d26,python,26,19,7,30
NB_0e7b50508dbaffc563a58a838e405cab54139df7a819a842debf91068e050212,python,20,20,0,0
NB_0de67a7bfb7516f78c4392fa5610c41f6d5895f01443183eb11b5251b87640af,python,12,6,6,28
NB_6cd40e2399cad2fa97220ce6daae53590c1c636f385a40688a660f8156cc18ca,python,18,11,7,33
NB_3dbb5ce912c95d890f9f4c2511f75d98502c3085201c67fc62459997d2412512,python,131,122,9,9
NB_f85fd43312135270687fd687ba982c6782ca1766d01132ff8ca4eba6b497816a,python,5,4,1,1
NB_719e5746f9951d0af1d7a66d912d9ebe3d3f062ac78a68d599bb011517c140f3,python,25,14,11,87
NB_ee99ca6f129203ce2acfc9f2740b0a6c8314bd88191e755042c89379644e7008,python,31,28,3,3
NB_b82c05557462df25df74a118e6c49e672aefea942a08a57b2819d8dba6a7e616,others,10,9,1,28
NB_ed44891cfb270c854fc015ff56c7fe7332c708ef003be2d5dd6a12d1d4624f43,python,9,5,4,4
NB_aa4b039cd576f5183e7c74c84bb5317d20478a1172fd6ccb26ca70fe2db63c9a,python,35,17,18,24
NB_41913b54c7ca8fe3bf59c8fcb11182b653cbf351160520adb07c79f0b71bc602,python,38,30,8,20
NB_0a1d8285ce383073f0820896ade20c8d89d4f58ca9e2733c8fa0998202314fa2,others,11,4,7,136
NB_9172f4047c590d006d73ce4a58d3377fb80d06cc20caae2ebb267278b618e352,python,49,39,10,13
NB_23d69426eefc7b9fd0ad0713601cdbe08b55bb8553058f3a10e0f004d03f566f,python,32,24,8,8
NB_d827d11f416088104f25565689a1e09845a2d66b6d1bdbc97bd4698c1fef60b3,python,25,25,0,0
NB_671bdcd4ad4c5daa840e80f58c11abb0597aa3590f2797fc0921d94f8b2ca11e,python,20,20,0,0
NB_72284eb54cde0237678b1ef77664464975f174e8740046f812146ddc31f6ffb6,python,38,38,0,0
NB_0d5e78f98096ebf7f80e4a4058de87a93947e003edf01202f194d8d747058418,python,31,30,1,2
NB_e58e34823e59392ae25c081667229d1eb9a4c8975c314c1c511f76b36934d537,python,20,9,11,132
NB_05d0819042760c12a44e0fc96f1e8ca2c5f216a4b5fe265632611ec937875c27,python,41,20,21,224
NB_62464d840c7a1d9e561003c1fbe8ead7b09d16a04c6fb723fe6b89ee3c8a2ef1,python,23,18,5,6
NB_e3b5d6192e4bf8b9de36f82e6ee57713dcba9b5e22b39dcfb00c6ef283d6e1e9,python,18,18,0,0
NB_c3079e989884741fad5c8ba6eb5f863142769fb4cde524629f29c48d63fcf2ef,python,8,7,1,5
NB_037f0c0e21cc1af099b443faa3b79d39d7c42c9939611e19232749b91a5e4274,python,48,39,9,9
NB_3d697b193b351bd463c971f96ac6ae50f19bce15de8fa6fbd07e7d325d005651,python,1,1,0,0
NB_29c9652e1bd16b38b5886192d331b3d306738b890d88f8743f64f18889f3f2a3,python,21,21,0,0
NB_6b896853aa6993cf2eda70cf08b494fd3b53db74e65176b5aea2753c83d42a5d,others,0,0,0,0
NB_a2c8babde24d3287d8fc5348087c988b58de4120614c78e7910ffd138d7dae48,python,43,17,26,230
NB_a6995f1eee612e8b3783f06316839abad6eed3afeae023da76753aa94daa7174,python,147,147,0,0
NB_338dfa004c174577bb0c5b1c9fd511de2e7acc9c0c9bc81b6548a9a6cfee2710,python,19,9,10,52
NB_7920df926fa6e60596960fede28ddbeb317f5755649e827f75393b9a8e707194,python,45,21,24,445
NB_e8a03482cd6730f714f737bddddb952181f11418de635a207b2e125011f8f163,others,16,14,2,3
NB_9f9d11dfc3877e4ca149e6d50eb19b9700e8b4bb827f1c7bf53d368753ea5200,python,109,87,22,93
NB_2f4684adb0a0491506f3711c66593e4a34f43454f56ab00dde4e529f76f83304,python,32,8,24,50
NB_5e553020a65fd884ad46c9f00cfc1069782a9ace3edfbc42192d684d492e754d,python,19,19,0,0
NB_89ce6fbf099ef6874c032c9b232d2ac69e1d00d5a473fd4a423286b072da1437,python,56,55,1,1
NB_ea9c09b3bd9603e29e1604d0eabf0ed3ceffd88bb9828df2651193a5ad5bbff3,python,348,290,58,58
NB_6e02b694fae88ba8ed6e6abb6549feadd93281aa16df2a60f0dcedf45052d987,python,10,7,3,3
NB_33d7c684b269df638a9ecc65ff86d32f580510187df071cd9c5eaa599913ede4,python,4,2,2,9
NB_f1c07eff6c698835c0c12839c566df90a9bff6aedd4c1809d40a42281902f70b,python,22,17,5,5
NB_2f9f59a7b62db5d194c48c44629d9463afc6fa08750b41c34d313f77cd31b751,others,78,45,33,37
NB_8ff215816973a640ff0adb50f716804d934e1c2e8cc859ac8e13cc57998a085f,python,18,11,7,33
NB_d9c1c451c5566e0d8dab3ed704e7842fd06ac34b237eea0ec17eb7c24b432dbd,python,43,30,13,13
NB_b85340c4b22713198c9b9919fc77728c33c537bfffd5d6f9b02b8e940b78556f,python,30,28,2,2
NB_84bd934bee6add1ed6e2ff2f7a278bdf859e56cdc2512344755a3b911f444ca7,python,10,4,6,111
NB_11f4805d667d02b9f1317844d4c725f2881e4edbc50ba85105f37e881951e243,python,88,47,41,59
NB_bf26d2eb076f6da7535c569d35f83dc7107d467e10c5a1058f43cd44c2c94166,R,31,19,12,24
NB_056693aaad4d71a64c53fc01d170d35f22204d8ebac56830a918544e5baff506,python,17,7,10,260
NB_bac42beebd026fc33f3ec31736d3c21b9cb3001135365cb0228dc01f2581e3e0,python,24,24,0,0
NB_50753819307dedb396b0b5b0873eae43194615e9444dde873e4b57013f072c57,python,37,37,0,0
NB_0efd9e980338e7492b89862f6ce3ec6823fb8b4bec22c58301b2a826370b1c70,python,34,22,12,106
NB_5be02f5a4307aea6e00e032451480d5dfabbc34242ad27c6d8af9419e74e7d6b,python,16,7,9,19
NB_b691ae9d3b3f3b53c6d6f9e21f4c34a9ee89a5413d32cb79fa59789c184361f1,python,89,49,40,40
NB_6d1a27193a9fc095bee720431c1aa99c569a71224ea61394413a59bc29fd02fb,python,25,18,7,8
NB_c06711ec7a684c63ed26937787206f65b6890920baa071c0e44baf5571044735,python,20,11,9,45
NB_5b58c96c30ff697d8846d533a211bef36e8f06800a9d5bce1e89ae88ce935b6f,python,3,3,0,0
NB_f4ad7aef71a52849fd9d83e36f7b59c09e39db11700eed3aa450a3cc6267d053,python,12,5,7,82
NB_6a79f6a3add200300830f0e23c81d1c0e6c8ac018e722faa944b34f10c89b8cd,python,36,18,18,66
NB_c5d141727297dc77dd8c3c181620204cb9b1ec7744d73bd56ad93fe57b812b7f,others,34,34,0,0
NB_58607f6e84fd9d27d7d43b365b9588f619d0205109a3bb6615e6854e8a84d11c,python,23,21,2,2
NB_8a0efc3aabcc1d6edec9ed698e6b77c54df769d7bca9870197a2d716e352e7ce,python,6,6,0,0
NB_03342956d3307701754df4282513064b724118ec7b48077d728d0654d368b754,python,35,13,22,79
NB_b50cf73d2a472e7b018dbf8d500278dab728aa2415f242e8be2972b533ab3e1a,python,10,4,6,12
NB_187fadb2065508ac79570a4102734d87e0dd319a3d0b8bf7ec9ee9dd73bc8150,python,18,6,12,54
NB_2a98971f5e858789c39a830557ad25bc2d6b9a74af080d323e437777fc3ede29,others,81,48,33,37
NB_a7c5761167e441888aa822d69fc0e833aa3b9286f729b5f6d2a705f91f365b46,python,29,23,6,6
NB_66991e25ec6c0a65d54cbbb1eb6656237201024606d57796632a007285bab7bb,others,75,42,33,39
NB_6f5920f682b18213d65a111b8408b8ce6272fc0e2870451169e14f30a7aa1f93,python,5,5,0,0
NB_090dde56ca05cf7a4a2a83e1eef77d047ae18642e4e965799cac9c693859cce7,others,94,55,39,44
NB_fee69c6aa09f5cc2a193728d82c5b669cc3f7c31189e5a5fc4b7b06e76f40eea,python,15,13,2,2
NB_14ad2e1b586bfb45630df2e947d7c6071b8f89285a5e903f7bcb86b6fa7afc6c,python,41,35,6,19
NB_4965834d79c407fad161be495d633b046e9d6906f4b72c92c6c380f04d01c873,python,35,15,20,300
NB_d7610ed017f83a41ab2cd7532c876c1861d21a2dc6a7b1ede469b79abf94b162,python,44,44,0,0
NB_946c451f2c32d6eafc28ffc0be8cc8cb4d9c2b5652796cb5a3937325b642b829,python,34,17,17,38
NB_a69d3c540816840ff4ac7a05d3b2db0ab057f8ad9d540d5d062336d4c17bfca3,python,55,13,42,266
NB_ac645f2dbed0d3817cad09c345133f9b9bfa08f5e615ce9941378444a9d6787b,python,36,24,12,28
NB_2d7c237bf09eb04b0b20a823940396ec7ea234d2821f99fa2e7212169fb13650,python,3,1,2,24
NB_c599751c9c720c26e71e9694f581e95de7c08766f5385b108ddeb97c399207c1,python,51,43,8,40
NB_6480598d9ade380bad4fd2ae205076350bd6e6d68770d29c8d8ee85b38f979a0,python,18,13,5,7
NB_966d8142469461b447059d2e75caf0f9e15c00ebc5773e84e4071996b47676fc,python,21,21,0,0
NB_c57d67f11b2eb4721edc2162cceb17e91eca41973a6e06a5b0e4b8d85206ab8c,python,38,33,5,5
NB_e17a024af724fa2a634b53ecc92fd3e7d5a2758cf2f9ba1f58b34a098a9bb104,python,25,0,25,69
NB_8adfa29761b02e14fd4c6edf1142d462539f108a9ea5e15c097901563560de9e,python,74,29,45,234
NB_41ef17e0081470d6e7383699f04741f3fe71d59728becfcd4f00ca904fc3e76b,python,21,21,0,0
NB_2edad58d017ae3fbc586328d69929389957f124a560bd037a62742f82a2cb3ab,python,44,44,0,0
NB_7d55503273258ac594361e3f54c40f89f0fa1296bf02f2066af02c558280cfb2,python,10,10,0,0
NB_347a8cf736b36fb72292884effa25afe417b9438b8b8dc5a935632955d44d092,python,23,17,6,6
NB_490b83c0c0ff8607cd2a81163bff830ab8a02b2babd91d208c72fc401ab4e5bb,python,27,13,14,59
NB_5f5037cf3d878ddf7d77e8504342490e498ef29d5d79523ac9746a78efa5e660,python,36,15,21,255
NB_c93e12a54a8a0354e634e2c3cab67fa03e549dd326b6377f72f8980be2bdc326,python,7,3,4,4
NB_d23db8dab269654f48726c1239304341689f9da82a35d9e62031d629c392ae36,others,20,18,2,2
NB_4b1b180e13bea4e107082ec5d0aa4e50114ff23ee57f1c92bdc12ff48bec8c81,others,68,36,32,38
NB_be9ac6a3daf321a2e09048bb341eb48652a124c70e9d98d7799b02474b135bcb,python,10,3,7,204
NB_37361cdff195fad3633aad4128f97db0032163a7123f31f2cfd82ce6789313e7,python,76,39,37,104
NB_2050b78aee4ba1aefbd0f8c3f4225734c1eb9648c03c6a3102c8cb6a415f81f5,python,34,34,0,0
NB_a2421d41c244eec311370e93155965ff0b2bf4e33b7a7a1062fa5696f92ba318,python,28,28,0,0
NB_bc46b88db2501c58f6308a5d2309e7f05e022cf78247a1122745721f19878b1b,python,30,26,4,5
NB_c658222eba360ec9ac2af080eb321bc3719378575d4608498c0a09e6c4da0304,others,38,29,9,19
NB_91dfa7be02e972fb8c771e45f4bc588b8f1f3bb02ae11bbb2c8d84b28efac686,python,30,22,8,8
NB_31d783a73028aa450f794763c9052ac3a805ddb853d17fe5aa71014716482e4f,python,48,24,24,35
NB_f39c3a9c8bdc2375b74a76b6bb01f8766eea3b8037644c7953369fdea8bac8d8,R,37,22,15,22
NB_1f5771064c992350dc489b4861425afb0a29318d5daa8d0768be1e3f086843a1,python,10,6,4,24
NB_f96f0ab626348953ca66538f989974cedec1283f42d491ba861be0db1745ebc6,python,28,13,15,123
NB_4d60a08301ce9dafcd42597f5389db2a9cc8cd2c3ca18cf2ad27f310ebaa73e6,python,41,20,21,30
NB_8a164c0988a9947587ac28997519b29bd8d813d16b2db94154c4fc2cc6e75f9c,python,5,5,0,0
NB_e9431d3f81b0a081869ab2ef3edb1691a7784016bdbb1fcd0541cc1da8659816,python,10,8,2,20
NB_80f2b6d44e8f27a490fc3e4af7d9be1b87322404d85a86d77a6af70e8c3f857d,python,32,24,8,8
NB_1f99e91f378b88c880e8581342fae959800a9a58205897be2dfb6947ce62047f,python,25,12,13,59
NB_169843cc57e820e8b49d8e452dd7debbac963a83ba5dcd131a7c38fae4790ea5,python,45,21,24,338
NB_0b2aff7fb5896b505761aa51315f9b7ff48e35d47dd00dcb960ce02e71faaf70,python,28,12,16,226
NB_78a666bbe45d733b8c47d16228b05bfdb9d017fe76713ceb1d04b1d55b975740,python,41,35,6,6
NB_7d643587528d444725e05aec3f9936e25d43ce3b028765449fb4f67706c64146,python,50,21,29,176
NB_5582056636abd9ae65254db0f30b02a8f0c766528c495ed8597cf11c7e618ab4,others,63,56,7,7
NB_9af7cb280d28d9d096834a8ce2249c5eba67fbafaddf4df940c248fbe2b2a9c4,python,168,156,12,84
NB_6e1a892c54c283fbb18946a2898d4e43a5203d0304abbb8a64131a8f4c1db351,python,15,7,8,8
NB_f1f8b1eac1379d264ab1be5161d7bb4ee71997de568ff2b82bf564eb8e9b840b,python,82,55,27,44
NB_460b09b4b917598d7d49dd90224f0ff83fb7d097fd25dde6bbc7382f42026f22,python,8,8,0,0
NB_7a30b17b595e8bbb8741bcf4be252b8afd93390c8a48d3013b023d1aa5836f5f,python,12,12,0,0
NB_d6bc3f109e2348060008dced250d719ea9ea741ffae4c9346a5819c1369fa095,python,22,11,11,101
NB_91bcf0dfcb7141b6beb101a4e59518c0cd9bf832c6a7299b6ceac790d0f30d2d,python,19,16,3,3
NB_24495022fc27fb373f0be0f23764b3bed2cc2bea2c61cc53ed73429a50c3f3ba,python,15,11,4,4
NB_c16250a7aaf8e06af9c3e88b8709170ba1fcc0c2a5b4dfa10b59a9f2901f2b2f,python,31,31,0,0
NB_85d52efce5e3f1b5d1c6909a4fa4e342aa3871112bd157d2f22b6ac4d705a1e7,python,94,89,5,5
NB_e965b37e26bd2a9d9fcd365b7f62a9eb6c1bb7569161734f6926a6f0417a9035,python,3,3,0,0
NB_2061608a2e8cca491b0fb01e4d4fc1329c18257e10bdb42fa0d11007b04603ef,python,18,13,5,5
NB_b8efb3787854a3cd8184ff87f701005783fce7d17828c55e48272c271d6e130c,python,8,8,0,0
NB_42ebb7b34d76d8d61dd891e141ad04deda5673da1d2c7de7d481652ab22af230,python,46,36,10,11
NB_d9be71936fc257181dea35736cadb329d5b3c6054273c30ad83add331b4bc9dd,others,69,37,32,36
NB_5a06c8a1b9e7d2eaa5171d56a3117cbc9ebdd90f12e1c08ecfd2b0987bef4d13,python,20,11,9,9
NB_fea7d79844239cc15356fc07a6a8388454c309faa44008678e9d3aaf9f69dbe3,python,47,44,3,5
NB_d4d8ff1ab5afe6424b41d8934915b4783e32d85fd59606d64ead72a4f3b71b28,python,23,23,0,0
NB_e8a016f2ace137777d16861663ab2e2a6f5f525eaa33e9b69401dd2fb9ca8426,python,9,1,8,161
NB_82651857c676dbfb251e7f931e2ec8e79e49e3ab8727b7a36cc5578ac39ad818,python,23,12,11,32
NB_38255dc9b82a85accfce17abc9ea504efbdde7508a321b84d70165e9a85947b7,python,18,9,9,17
NB_750d2991c8d99df3eb8467ba53b6a6be2dccf04bc0a17216277e05fdab8c3ef1,others,12,11,1,20
NB_76228056802921b31147b0848782cbd6fd321a32898cbcb415b680ea57223ec6,python,29,27,2,2
NB_785760ed8aba78955f200a00be8cb2405707e15a6f1b52a10ea70efe4fe5e89d,python,18,12,6,6
NB_89461b82d53382ff58e14142b0839356aa072e368e4b3bed18eabe209131e5cd,python,23,22,1,5
NB_ace2c5ddca8ee6e0e073cd72f5822fbb94f3d83b9dde2b7bfaf08640c12f9fcd,python,16,12,4,4
NB_a78d0395eb9f0c4c45424f71918432fb1548d9d2ae9541f4ebe71e771730232f,python,33,33,0,0
NB_7cfe560f9fd3c6c79d81c41acdeb2a5f4d45c9c37c844d837d3f43e1cf7eafd3,python,7,5,2,8
NB_aebb2e9f599a9208e779950b66511d203ecae77b728f4ff3a76379c1031214da,python,11,7,4,19
NB_0ad6e92d1d81b2aff76176431adbb48f96c1d83c555f5738e2683b03a3d9b5cd,python,64,59,5,48
NB_399030f6935f84fee1f7cb3a90242246d09d45c1f59fe11b9532b03b744742dc,python,22,20,2,17
NB_cd8d5f2c22a66a5c6187255945489b306aac1c87f2397c675d17fd05df7f6bc2,python,11,9,2,92
NB_84b3e5baf9e58aef20a760c80c3e5a061188b3cacfdd6d776cc82b783794b73f,python,67,64,3,3
NB_e1b5a67e66986faf9dc042c64fd1a05aa5546cfa7c01f25cf8e6aec60a60484f,python,12,5,7,13
NB_f3286b5aa10621947814eb7f990a9c545d0d82b35d902aa36a9915a2ceaa1be4,python,15,12,3,3
NB_18745129fd2118de0f629ecbe8872beef54d50cc8e8ee9a06b57bed974079f88,python,22,15,7,7
NB_e8fabb37dc2d5e90fd21ff31dcfd8ef1fa393de24afca97a609f71692b8e3e7e,python,73,73,0,0
NB_a0b8f9d4e945fb5d472e5dc8a0777d291ab94a5b0ead1465d35e7e27a77fa793,others,33,28,5,11
NB_bc683c1bbd405ebe0a25ccdc766f9fc7d096ec5c27827f5348869d772dc5db1d,python,6,6,0,0
NB_f58f6b207a7f2873003f731b23b602bd69fe35f18cac127cc1bdc0dbe69c8ad2,python,3,3,0,0
NB_1f3adb56459e8f57b8d62f3f31b2ec4b9869056b702af89cbcc377c29b1c5ec8,python,43,31,12,35
NB_8afd47b90da4db2e5554585e3a6fd47450669866a868490e1c1b4585e1c25965,python,17,12,5,169
NB_afe34ce12b61dcee86c2966e4cd1dd62881a75a7267836b4fb1c2e9301c262bb,python,9,9,0,0
NB_55e6358583db17f71b8aeba276eb27aa562937bf2fcfc4cbe243e8ce7208e38f,python,3,3,0,0
NB_e41ce4b74f097740542641e6a736a3727e35dff59a215892e666e9dbbc46aef9,python,24,16,8,18
NB_a37b45223c66487ebc423a253038cd336da767392a8b8ac4ee90dcf667c37fed,python,12,8,4,4
NB_f08b830c46e1713c6a13e0bb817729383f7fd23789af07d9bb6324e60cd2725e,python,6,6,0,0
NB_442ed5ab78d18bd9ca4ece9b47767ef9151d2a6b804a6ebe4559c7d5543ef209,python,58,56,2,2
NB_afbb259b91d3728d3ee981db9b5ef4ea534588adc0fb9315eb6574a824930dee,python,38,33,5,5
NB_0f5b695463863463a0014ff8bbcb2957ff980c2056ad9459f9361e9236a425a7,python,10,10,0,0
NB_663e672dfd33692230812db63f94a364d8c4d3675d88685c148d3c5d50e72896,python,75,64,11,11
NB_414f5d78dc2b4310d8d6be6b10210c0d22a498ea3a432292b0377ab9f0031a27,python,16,16,0,0
NB_805060a5debe3d051481553484cebad9ec4c9ba462a59921bc0dc605fae7409a,python,51,24,27,541
NB_c4b72bf8885666062f39d2c3e6016d3c03f7cb0f14dedee6ae64d3d4929e3349,others,96,69,27,52
NB_97b3cee400cacbf64491edb05cc1bfaebf1e6c27b1706edb3688213e0ae06dda,python,25,14,11,37
NB_39c11f56c96dd6f58a0d828948e1a273108f0a75eb143b6b1e1e14fded76a875,python,13,13,0,0
NB_29b9e4ad08bfa3f799154580e1e664bd7f8eec9a63bc3530cc1d6b26e157b681,python,34,25,9,9
NB_40a39503a4a710e53954517ff2eb2fe024211da6a623a9dc451898e813a1fca4,python,9,9,0,0
NB_cad55d420f39ad1b360e3626fbc491bbea0d7ffa932f4d6eadbfbd5cff9e36da,python,17,17,0,0
NB_f86b9b02857940dc5c11ce1336aeb2a893a810f6902150c14e553ed60c97fdce,python,24,10,14,128
NB_2841f5724e32c2e0803eb26cdc45a5cc67ab14d7f2a85c0dd8dc39d5d1747a58,python,39,24,15,21
NB_3a0503be35f2e5795db574019cc48b1137e75c4915d66352cf371f14f38931ae,python,49,20,29,177
NB_a63faa10d5834dbf2b9492c689b873c2eba467d031c06e13897396fd7d0d1f34,python,31,25,6,6
NB_a04ea3affc6bc2d7f3bfa3bcdfad9a90d5e8b3007a058ed958eeee51cc82ee7b,python,43,32,11,11
NB_a8a4e5841759f27afd383b931988d7e34fa67d2980188db8a82ece418a977376,python,60,31,29,158
NB_93ed48c17bf6cf54cc4367f87223bde31155e88266de9e91ef577d6a47d8e0a2,python,35,14,21,45
NB_028a0978f842efe53bfdd2b870d64e686910e88270fdcfeefc119bc855d71c91,python,15,15,0,0
NB_1deaa4fe2dc48efc798a36470cc3ee184048612005c3f6cbee1e082c51972b2f,python,54,22,32,542
NB_a5fa48002691eb1e9e24f1c5e45fca3b05036e10677a30e4a39bfdfad27abad8,python,43,40,3,4
NB_317967a75c3dc5fbffffcb016e24642032fe5946cf839e89e14eff19dff77044,python,33,33,0,0
NB_76b09b5d5a9c487f1bfe08b166ba13a00cddcdb9d9e6d04bde5f32170fc35810,python,22,15,7,12
NB_9023012f8e4473fac43715eda9e963f160dbd85a2153817893fb932b7101f6c5,others,46,24,22,22
NB_b22c3060582813c681b14dad46a9abb0f24a142c90087083298e4fb2fbb27c32,python,133,133,0,0
NB_9cee86f0a9671e2c9f58d20c3e29f7e8797998500f8cedf83529de2ebbb9278f,others,0,0,0,0
NB_aa67fa4971c8b4a584cdbd55d74324d7ed9bfd0975560d68b59c43268fbb42cc,others,29,24,5,5
NB_01b4f50d3681c6c53a2c0d512cd7b7c463df4a1a8a6626149996c06813d4d481,python,11,8,3,3
NB_6ecb1799602cbc25e3e208829e12f8aca710baacddb43adab2d37356b2b6b636,python,8,8,0,0
NB_7d9a5fea8edd5b42279ef780a020fe2c25921c2cadbf38e436964774cb932522,python,22,10,12,164
NB_be144123d28952e0035f2ea0fba801bf7584f8375931f5977dbc0896ebb4eb62,python,3,2,1,1
NB_b2e51bbdc51a601065edd9ea92c4541ae27cb569e4c50740638b882cb66e07a2,python,2,2,0,0
NB_61a508c325514408a887d1646c4b2f3858a4e87bfdf8153f8e581632a2fc1cc1,python,15,15,0,0
NB_485df67142f23a600202aae8da738c1c7eb5ed2a0fae6361ccb0cf30a690be6b,python,35,24,11,17
NB_9715429c03acbdd0a5c99caa9f90d2548cb541b896138d7e5ac70cfeaff1ac97,python,10,10,0,0
NB_bccaadb94d4bc4f67ec8df70f363079f5ed627bb634a0cb1295a374050349944,python,12,5,7,80
NB_aa6c31be6480378ab391d50195d12dedd2b021a28f115669aba5c32297376cba,python,9,8,1,2
NB_45aa8a495a07a188dc8cd2367e6cbbd85627a957696347c7d9683ac0a91191d6,python,62,48,14,14
NB_01d9415f542c2961793cd6e9087ef4af8deb679553f4dfa4f57121abaa1c454d,python,37,21,16,25
NB_0227e7563c8a7770e98aba17c16d0e8f07e5e1858cfa0ab37a00ac48c885b865,python,22,12,10,113
NB_4acd1f9dcc5bad2213240bfb0fdaf76d5cf7988361a8f2ff8421e5984e68f917,python,15,8,7,18
NB_2d66c2b0d21bde823944b416eb872679a9db9764c31de325cb909b00c8f8f3bc,others,0,0,0,0
NB_7c4f502b28c33e2733c3fbd80492c13bef31dadca59644300efde33b4195921d,python,28,24,4,4
NB_83bc5a0069ba5f16bce6286756e975e9e7c5a61b42021da72419195f526d76b5,python,47,33,14,4389
NB_626b39fab184928d85fef8f3d310e52dd5d8415bfa18ed36c3757d42189164cf,python,15,15,0,0
NB_b73ee2581aee2c743c1a50925bfc10a2edabb05d56201238dff17be37e5546d9,python,19,13,6,17
NB_60984202d888e73eeb6082182ceafded95a6da391020cc18b06c4fce13ffcac1,python,6,6,0,0
NB_48aa355c75a6f8237f5d1d7b39d2dea89b1eb8dd1f33e16656fe7ddeb52e0323,others,78,45,33,37
NB_360c388ab05316070245a986918c0ad4073196c90df7faa5209e4b52c89ebb62,python,11,4,7,61
NB_5ae77bd5110e9d827a974ce0ec32b977ae56c47403e943afc982ec1e7c7a23ff,python,11,9,2,2
NB_27508a1fd52485a4d0f68c9a0e5a41c0207b6df279380fb9e89b37e57ea0ea5d,python,53,21,32,542
NB_cd974274f64b7d5a267ce2c729c770eec5678261e5fe0b3bead778dc3aad7eaa,python,42,16,26,248
NB_82dc1303119c7638d93318f2b23771bcc90aaf3220f674d115e75d8771f536c9,python,7,7,0,0
NB_b63a2fe6e37ec42147f03a92560af166c6a6eee88b9b188c155979591edb582a,python,10,10,0,0
NB_652067eb76da11b11ae42085a3952591859fa23672b94b3531faea06eb918133,python,27,13,14,59
NB_6d7c759336438f8f53c41852895b953762fe99320607a1f51862e1a38bdaac51,python,20,19,1,1
NB_97179185ab8d4e0f898fa666c2952133325665d36d8f63f1a3b550c4a47dd336,python,4,4,0,0
NB_adefe8f7035d28c4b9be5ec9c852a6a21ff43d43294832d3a49f075ab80bbb9d,python,45,38,7,10
NB_c61c810b318ebe48ee5b720ca49270f4ca58c387c02e94cb015c793de99abc86,others,51,46,5,5
NB_fbf6b188135768050b8bd2a7d3c31fbb19371b71c51a8dc91e9c3f09f83cf34c,python,19,9,10,52
NB_9d2bc615a3e9001ff974adcb2563b8dd420797bda026b9c2d534f98427787a68,python,36,17,19,169
NB_6ed52ce36271390b4fee67c35091f1d946d2f5a99ffd9950d066bbf316d91865,python,25,25,0,0
NB_af043f8ee2358d7b48a6109b2789ad85783d2f80d699eb7bf4856a59c6a4720c,others,12,6,6,19
NB_816aec11731c6c404f360cc086df742ff09fb50fed41ff520a5c2ebaf2512e1d,python,139,110,29,29
NB_e9786447cdd6def76875afa5745847dad0cc7d028a4fbce66e7eed679894d2f6,python,66,63,3,4
NB_d389c296c6055150ac7e5fcbd898dc18ef10be2458869eb3cede2bc3e2ffed9d,python,8,7,1,1
NB_f2ec5c472656b23e8c569767bf7fe48188b21c9cb40832c2b498eca3a8fc0352,python,19,9,10,61
NB_464b1d9d1f35e5af0c2577f188cd4df7b8f994b884358de73e69d95be57392b0,python,27,15,12,188
NB_c19974ca6320bed487f5a79385eaa58aa683975265323666b264a57f876e1f36,python,14,9,5,7
NB_503d180ef18c671171e32b6af12705cfd30dd115b8629a32e4790c07aa74d865,python,13,13,0,0
NB_94aec0ac21fade4cfb40a11049dc3380f96dfcdcdae9fd9c1c3a2e16172c9f6d,python,5,4,1,1
NB_a7ac4d28f10d0fc59350f5193e20c32e568d2f03851b82941ca7a370d0103481,python,26,19,7,10
NB_32888c020b39aa016a3f2c98164187addbc15bbd013e2e3cbe0d948b16381975,python,22,10,12,115
NB_272d14948485fd8c03be9ac886687e87a60a52663109ed590e4f033c71d0a0fc,python,188,143,45,61
NB_d787fefa95635f1f6a137440c6eaadb25937baaee3ba7035c124b0247c6a9d10,python,15,8,7,11
NB_f280f467b61261b5cec0727dcddbc2008ba531764f5d0ef9036ca813d2b8f6d9,python,130,118,12,14
NB_3f5ba06d6560f0e180745d25906cf4c74bd62ca99e5a72e2a54e0103b2996241,python,9,5,4,6
NB_20d6ca768c838236b52829454665061c869f810b64dfb4ed5fc986939ab818e9,python,17,8,9,11
NB_2be2a29914a0ed4ad62a3878bd988e214bd1e4fefea813b6c78d48b1dfd41eff,python,68,61,7,41
NB_0ef7cc859ee4b178a50c98664831cfd2b510304ac145b6e67f3a4c4bb8d93b6b,python,16,7,9,166
NB_e5adeace67d5dc8ed5bc791341ecfbd9fc132e83647e8880bee1218b45faca19,python,143,88,55,196
NB_a9385b295222339e057913c985dbed2271145486dcdfb506644e25650d215f05,python,75,30,45,110
NB_583c7697eb5f29a553710aa1fba09e091ad7a5799ab3f32c5868e63956e06aa7,python,45,26,19,26
NB_3fd0ebb8da0844811a52d814c2597719fb3e347c6b225c2dcb1bf9b35a321029,python,61,42,19,44
NB_e102c1e7334ca915dc17b380474826840864a3f891069e41d0de649da619dfe2,python,8,7,1,5
NB_f2c45b84768dc83cab08560086efdd20e847d9c39a348d10998a481537b787a5,python,71,26,45,327
NB_786c2360315625fd028bbc8bffe3e87526c0de5dea119d2180f987648a084cb9,python,4,4,0,0
NB_af381ee19dbc736efac0b17ba987d6ca45b69839b8d0a1818dee8144540797dc,python,63,43,20,36
NB_6df6a4de694fb3e0ec9d0b6f11ce00c32afa482730df8e5144663ecba224e79b,python,52,48,4,4
NB_ed3e71595b1ee4740421f977af77f503fcdd949708ee84ecc582e2863baee70d,others,182,150,32,58
NB_c2d6d7452f6f7d67af9ca8c89b43bfad85330e47b274f914d1dd76424c928821,python,63,31,32,34
NB_0b5741a310e8f9e5ba32a4735bded6361bf579d6e5cef70de78f96c9a76d0051,others,11,10,1,1
NB_cc14ab3772cf70cdcf86488df0ba58081faf9ca37863c765c8c9fc1b277a5226,others,29,15,14,20
NB_28412cfcbf66623cfdf90e95c62ea8b5464bebf2cad71e1fa7f64e8f3f76d828,others,165,89,76,76
NB_0dcae2b4c30288cba862357b3849d8b3f40576b86c30515cd015dda1f231d513,python,66,30,36,182
NB_6e003dc8470a9f72e5f824bef40c29eb9f8008a3fa4b9f6e136a69f631d60219,python,12,11,1,1
NB_d3f778a21e40c7f27395923ac0aef9960d37702b9879d1bf9918b4a858722672,python,11,10,1,1
NB_c346c6ff933bd5c8a8755b7860a599a4354d5adb2d6ec0c24ac2f1a696a25b1e,python,24,13,11,37
NB_c3878df6e3930f1a1166ed68fd9e34dbb391bab3486178f5141acdab2218bd5d,python,4,4,0,0
NB_3ea8bc6cdea530027e6e0e5bf01b1c8b82bdcaa30c687635bf2690b01a819d4c,python,14,8,6,31
NB_75bb125fa94e9a5e0226cd57fc33e6ea289a7bd312b50acbdbfb69bce1e7e2fa,python,8,4,4,17
NB_a7df6af30fb46da3f2fc59de190c2e00843941072f8245a09d7a5d0d7bd736fd,python,21,0,21,515
NB_5ad377692700b3421352ca31388f7495c5657843e896b7a92b34de26350fa556,python,19,10,9,47
NB_d5e5383340261710458bd0770d0efba2c845b5472ad175820d85747b7a00414b,julia,47,47,0,0
NB_f252a1574028005cf5210ea17dfac50bf22f0b194f56384b201d7b39b25cc2bb,python,14,14,0,0
NB_c7809aeedc5b774d6f9d549c14f7ad9c87cbae65f557ce4ab55409cef81f9285,python,27,26,1,3
NB_cc03b9a8ddea05744c396c8c9d4aae688a4734ba34c17ca9f2370b82740c85b6,python,14,8,6,9
NB_0f5a7b8c4b24d407ec0e6d194aead2f7bd988da6d2276a9b23c4ab7a901e1eda,python,17,17,0,0
NB_199ed27959c5c72bb02b25dbc96ac45665c13d8a55878ce1691abc93318eaa93,python,16,15,1,1
NB_6e86ad83ce8dc3ee85a0cef96efaa3d02de919abcfc5c26145e1382279e04f34,python,141,87,54,199
NB_d89450c789974ec463f9b7193fd1a5ef322a7213fc16e7da53921b7b8be2d428,python,9,9,0,0
NB_af5df5a5539ce9460853f2ebd50f2130b639fb80f01fa034c8aaa53946511d51,python,9,9,0,0
NB_e82e2fb760eef25987cbb8768076b7cee4dde4020ea49f3816f8db53ca623ad9,python,9,9,0,0
NB_e8f7dcb7c14b57e6df5632d4cfb1bcdf4d11bcfe23ceede4af7ff0339ebb6797,python,10,10,0,0
NB_ba67b12535b57b94a1b2b2d99fad61238ee56c013393fd1dc5f0f038120493af,python,19,9,10,52
NB_6675146b1414e9f74a53f41cf0d027f7fca8578e193fc7eb6ceaf98057b04382,python,18,18,0,0
NB_e4d63b9e1fe18648b2c8019df10779a7b70958eb68b7e9c82056795b5407cf4c,python,9,8,1,9
NB_4daae35de0cacdc616695d12a8383596175cb2bb65e599bded3c71258586ab38,python,92,84,8,8
NB_e93fa85ca8f2d57b0e1e2c3f329757c132401d3015ccf6c92e78b8f76e988929,python,46,46,0,0
NB_ec57c85fc662f1187b9a167b66927e1dcc05e0a30a43c4327d6af4224cf990f1,python,23,17,6,15
NB_f1e333959ac9eaaeace5c817cab1e8f8b2daffb04218d04ccf1b31a7e039e627,python,14,14,0,0
NB_2f781ecf0b100020dc3be6f91711d57c6ba1356b87e48f81431734cfc0bc3861,python,48,43,5,5
NB_a9b4520029cf1e59612b778f8d3ac49527f22dcc45b733f5e766873e65e799d5,python,45,17,28,276
NB_2a00aa7e171d5a1b0f91373467abc5c4954cb08000734c8c51c3897836b57b79,others,112,69,43,274
NB_79bcefe0ed7e58258cada9c17c1a7b494aa7f7f5de63e0db23802d19c5136461,python,47,26,21,31
NB_600fcaa1caf9dd5e9d00725502e1c335adcc7eb82286112bf41e400f8b68e2e9,python,12,12,0,0
NB_0960af9737c0153b90c15f284e487b7c032d81611872f062b8a41a8c6bcf01d2,python,45,18,27,223
NB_8a3f4508c0d4aa9ff230d5ea3d879a1d100fdda3e5c217344ad4ce3dc0e38b62,python,5,5,0,0
NB_3a1074edf5270513f9f94f3d5bf4672bf6e052e2ae6deed77d0d696799a86174,python,2,2,0,0
NB_721c323d66cbd67c1e9b67cf7d9e49b2fb4878dbe19c8c6a9680c555c493fb57,python,13,13,0,0
NB_e7f48975aff4a45583f5d6ad75b58883781472c58cf0eadf0420097c49e6f8f0,python,18,18,0,0
NB_6c34c1b73635781da42a3a6f1699109a388772f1fbcd24f3ac2f7d81e5a2bdc5,others,45,40,5,5
NB_82dd9fcffe55839ef4b2d9878cee7658c152f060d674142a444079d2ee8a6199,python,38,29,9,9
NB_7cf5f9b23929790caac61eb1f5476cd37c0005ba7d6eff8d3f438576d65955dc,python,5,3,2,3
NB_4dfa89f9bf298b9ac2a0ab29f447b6476906fe93985a0cbe25c0e8e49a7f70a9,python,66,53,13,48
NB_2a35c0d28d5afe5b004037fe6f878e2311f06e8c350af3323f5ac44fafe87251,python,32,11,21,202
NB_bd303b033ce2566f387b5512f4f11c95334ab26c5f48b9bc273c6faade22bb88,python,9,8,1,1
NB_d7b900657f69a113c95fcc4b0b76320180d6504952f47b3550c01a7c460c4bc5,python,19,14,5,12
NB_c3c82f400e19c07868c96fa9c3c86d9d2b5f524bf9b15cb76f57350ee66f78d5,python,47,19,28,32
NB_cd85b1210e8ae6452a5265c6664d7da6477eca2a8f950885e05fb6b76da6df59,python,13,13,0,0
NB_164a8c75c347940f0766043a7d9ddfd9d2b0c220230c546e93b17e243c2dee3b,python,9,7,2,2
NB_0945fa14fdbcde57c089c4453ba597244d61b80844e30874379d12e62da2ea63,python,8,8,0,0
NB_cc1389a400460c085ef9c7ea19c5442f3c6ec6d91eb55f64e6fe4e1e58c58b76,python,12,7,5,12
NB_3f4e64d00cfea2eca12455c9097919375070df00396af072dc9a4481f0022cd2,others,6,6,0,0
NB_85a25a407d124002558ebdb8626e95359eef6e4a7e90b9d0cd3b02ae6d966d32,python,6,6,0,0
NB_ebda22ce51065ddb6a54b544fd6b8c43d3f8c4720e124682a935e5f101e76d14,python,73,52,21,24
NB_496b61652312171fd30220f90cf2db417bfd25896b6cf45a69ca78e793bff4d9,python,5,1,4,238
NB_438c4adf3e1435d15d3331be93d85d26c801dab21f0e82a0aa610292a7365d0d,python,6,5,1,6
NB_701656583a7f132c85a1883ca2f68ab548c20f8cf6813741fe7312119bd06799,python,4,4,0,0
NB_409b584620df38055ac22e0593f34a03ef908897675fd5c16dda9cece54b176a,python,46,32,14,79
NB_679d825a9948387e948f9f38c2d795f75e7e9312e0c781834b1d063b80a631ff,python,49,20,29,178
NB_e7096552c401e776cbe732f57cfbe8d179bf6ee3e01954f84be21d05d274e082,python,109,87,22,93
NB_f61e7b262a22f84a947c8597b953993bd8b8f11f6f86500bbfa52ff34907223e,python,9,4,5,82
NB_14a008662a7cc9967b2699fc124cdc64aa771f937554dbcc7da4c434bbbe9b35,python,21,9,12,74
NB_869afbc3a940a0eb79a2cf235a118cf2457b3525fc8148aec91ea80205366a1a,python,24,10,14,128
NB_4e679d489c7ad9c66082b43272a0320f9782d76f7e1b75c8f9698884d149c1a0,python,11,11,0,0
NB_0f2211f7f042cfc4c448b9271c59fe6f7abedf38197ce492d31ae1dd9fdb7d86,python,38,38,0,0
NB_19e651d9639fff36a030706d981343726d1b1a7ac72252911862bcc00250bb45,python,66,27,39,56
NB_6fedbccb33c43224702b706ebf1b80ce6bc172362dd877b85571b63fcfacd4af,python,54,54,0,0
NB_cf6ba45dd05bc7cbf8958821ba7369006216ba0f56abce9db98f7709756e500d,others,30,29,1,1
NB_09eee05dd417a7258acf00cf8239249e3e92a62ece4597169f29de8a4698321e,python,16,16,0,0
NB_a0bdc103406cfe7c31f2571f9af4284f6468e836a16edb65646d0f8d1aad6461,python,5,5,0,0
NB_2b956a5cfbfdd921df20d0e30a60f7cd55c3cc65215b1c573ca0301f3cd761da,python,20,19,1,1
NB_71ff17746361e643f189ccd014a8e4fb3c155648018f1485e6fb5004f096bf26,python,23,13,10,18
NB_3aa8abe5a910de104802b7d138121f9d9922a49606c056be7ae2e78ed9dbbf86,python,19,10,9,47
NB_a65407a65334c054664a5dbcb5748c429ecbc29fac827bcba5852159c5633c5c,python,27,15,12,38
NB_3e895fe50df061f828e4b383f262e4394a7584009df1c098bd6a91fd51ef7040,python,17,8,9,15
NB_9b9f514506fba2b74271583f2ebb9e284d22c996649bc0eb0226c4b072794186,python,22,12,10,16
NB_d8caed8dc5cd81e5144f9ea3eef1768af84d163c4190db8b47b5b3cf0800abec,python,47,41,6,6
NB_737acf622a86d201166a81b3b1595723f709bb2e7701a3e11f67c8ead12c7368,python,18,18,0,0
NB_bed4f1d18cafba5f7f477bb3b783bd6ba8a6421cafe61c08a8e7f0a1d1cd33cb,python,41,19,22,443
NB_f3444b7a44f34c1bcf7de9853c47306f140d332b6f6cec8a9bf5ea5a0a22293c,others,94,55,39,44
NB_72a13b0162556346838caa5433ce55f8019bb55bbf06a21c078cb9c87bf997a4,others,94,55,39,44
NB_dd43c605ba7ad5ab074b76b61c49ea70ee41b346e9510f1fd975335cf09ff0e8,python,24,13,11,37
NB_3536c7444fa4c29186d93bdde3a0f370492d96a8e2ab59ea52445671c99994b2,python,39,31,8,48
NB_b8b7703c837e49b9f6616b75063f46fda8b36354dea132a9ebc75383af9c50d4,python,30,10,20,204
NB_f8941a2d52115643a70e370c8d39fa6f9760de2f95e680abad2c8fb855ac448f,python,48,29,19,19
NB_86b758289b4511d3a517dab63c7e58474bbaefc4476fac8a55c8351ea515e06e,python,33,33,0,0
NB_e4eb0abb2ba62d1f65cf6a3923b603d7f32eb3d97ce514d4990eca26acb0d19d,python,64,55,9,385
NB_0f6a191406df2f0deeeb230b34aa929bfaf98480c8e9035c6b3ebf336c4c15ea,python,28,12,16,143
NB_71a314ae25f8716980ce46a54019c3ae29b7478eab8e4f0614138a228e4247ea,python,74,58,16,16
NB_bbccb605adefd485495f7e291df11833d14640f5a51afcefcdc41cdd9350ce06,python,47,23,24,24
NB_1a8eb9126a316d3106daf461c11621a63c796b600f234dfb0df9a099cde14e9e,python,126,100,26,30
NB_ca5780a7780a8272514f1e2fb942c86565d6b6146deba7041a11b24bd215ebee,python,32,16,16,54
NB_eda3a8d547569727631790ae357b7d4ac8a39ea7bec8262f893c480b9f6412ce,python,8,8,0,0
NB_a87ae3d02264621994f2dc285ba01a26eb66923cafaa576e48f8b18599ed4843,python,16,7,9,150
NB_fb2f00187a77fc39ae37486c167e855d39d29fb62646af291e1522cb5878604c,python,19,15,4,4
NB_8d7c488812a2eb07f0a190b92db60cbb34b0cdb73c238f3a24421bd42a63e450,python,43,20,23,43
NB_f5a421b96ec6fd57ed800ca405adeb9641517edb51ef4a09057acc1fa5c70719,python,11,11,0,0
NB_e1f06d4fc7c237bce6a696ff317f432838391cec877e2b8b50e7a8f533c9df28,python,129,71,58,81
NB_434e9cb941da5773fc5fc61b06706765a04fda26f27982fd2fbfd4c49ab763c3,python,19,19,0,0
NB_2b9d851adc3ec1df5c964a41b4d18e3d870bddc51ed97e86158d62dc6b4caae1,python,151,142,9,9
NB_19f7f3b7899cd8385588719ab5bc924871f5473dc2e0e4cc1cba66e9b3d9e996,python,55,28,27,38
NB_5fe56d0d6e86bbb95c27738927c2e2dcd6a52f39111f77c0ce8b041acb62b15f,python,44,37,7,7
NB_2b97d5404d75a4c22e49966281a82cee3c7b7d63f2d697a72c97da4710066c73,python,27,14,13,123
NB_9872a2494c50dfb81c8fffab011fdcf72e2c6296a6b12b0188caaffe748cf295,python,14,14,0,0
NB_e53b93685f262a66b4bbc293b41983f3e205aae8fc86475e223e85e5b76da76c,python,12,10,2,2
NB_3938be024e42f940c4e2f0424de9d031b2849fe5a54002684b311297c27cf276,python,16,14,2,2
NB_7bf30d477aee768eebe7012a74b130e921857700099ed0cb81ed83402ff43f36,python,8,5,3,5
NB_66bb259d4c977ecc3321ca5d6816dd64f661c93bcc50e2bd48da5c0510eead27,python,6,6,0,0
NB_bb668f9722520c5d1ff612563d08d651b8c3e4aa0caa5461c8df87adc9bdfea8,python,65,23,42,393
NB_b01f073d779ff233936a6ef549c6e98758c64cec1ec9dd779954f58b64227e16,python,56,18,38,578
NB_2c892ba3ce3efb8d8524317fda69e14a76fac84dec176d43673f417d023c8e3b,python,10,10,0,0
NB_fcc0c90c0a5aa426e8a863507e044f1575c3036f320e9b19cd5bbdb6e157f822,others,58,51,7,7
NB_94c5148b375823db559a96ec6fe5e3b0abcffc6e77f2a465f39cd4288e53619d,python,118,77,41,57
NB_f5bf086946d1b453f1197755f4acb38cfd640f40ceda085f5231102f723733bc,python,1,1,0,0
NB_569f76e84a8f3eee88017c9cdc957f55ef54853949b4470616204a9a66ecf58f,python,34,17,17,36
NB_dcb5e8e8b7cf2db715dae9a4f7c5c0ae7fee2048739c4c0174d85fad6eadfe92,python,12,7,5,47
NB_fcb1dcef0e9558deb8513764f837530e1701d0ce8558699ddf8072d6aee7cccc,python,1,1,0,0
NB_b0cb56e67dc140e6cd243e9570e26bc9948aaa913fb5cf9f522c350f8c744cae,python,37,37,0,0
NB_1626229643f80ad57a84b50bf2ea599829cbf1c61da27d089ccb18eacb800f63,others,21,21,0,0
NB_10df452e2d5f80fb924560fbc7176f37712851564f9b3d6338786420ea121686,python,21,21,0,0
NB_10ec9fe6fe1722e1f968a5e46542f71d94062b7082a066252eec631ce439c23e,others,20,19,1,1
NB_cec43931bd65ed897177569e7e3dde06d9ab06ab394de9d8d37993d581cbb91f,python,2,2,0,0
NB_c68e8e8fc940dc63bf502d75e5f8d2eb89302424c005321145a5868b4dc5e056,python,40,40,0,0
NB_aacdb891f567bc048f6fbf3117e39f06fc20146a2293dcdc1ed8edce4ce6f967,python,40,39,1,1
NB_e291f78a7e96bd47e08b3d333a86585fd7fe1e6ed2491dd0b4aeb741c5e2dae5,python,14,14,0,0
NB_9a554934f55b04aace1762a4d603d93f7332f0757b56d6e78b0e21ef0145a753,python,5,3,2,3
NB_35dbba5b32aaf07efd75e86f82c21ea523182c05e8c07b99ddd534189385e9ec,python,197,154,43,43
NB_8161f034bd7a36325676b2c710cb6c1d2754f5c145466cf9e4b71df975034783,python,15,9,6,17
NB_d974f4a8d6ade756dee53b1cb22766c9487e6bad1c216a9a21ba71a66a462d98,python,140,87,53,193
NB_5ef775948b5dcc3126c9e158a01e934ec6b32a48521ce3446d9ef49b473e2c64,python,15,14,1,1
NB_e4686e92c264b4f2b48daace0ae39dbf94969eb604dfc259b5ae8856bbd4c29a,python,34,26,8,8
NB_dfb54424226412d4edc2c808c4af8d9478a6ec298f506eefc1f07d2eceea934d,python,43,40,3,4
NB_95beea852c814b6b990eb9c787f09fc9cd8709c6313108eb1ed50b345dc95f4a,python,2,1,1,12
NB_de594ba4ad52424ee5032ceea658ee5d3da502005d8a2bef3fef089bc8ef28b4,python,49,26,23,33
NB_babd445912f8768dd8289842f9652d8d6c75c81f237bf7380b9dab04dc4fddf9,python,11,11,0,0
NB_e04563e7149324bd70083d3c153a2190bb474ff904b68ffa6d216f0a04a583a7,python,57,30,27,78
NB_f8546d5d1935d6aa428b14471c7302d5d486057d21d96940dafd6f0be3f4f1e6,others,94,55,39,44
NB_70da39ec93569e4e1fc791a9cee97c22f15a6823bd404af47862dc828bfbde98,others,4,3,1,1
NB_f182aa82056e5f36016f58401eeb17b8fcd4efdb45f68a09ce8c5010a8bf2a75,python,86,33,53,789
NB_ee9d13b7aaa9aca7dd0bf305f7959720356fd807720046d692af2aff1a53c888,python,30,30,0,0
NB_d1ce76f278d9f9d99e0a22358ece4a333cc6e762e9b32a39b28c7ecea4b8bb65,python,8,8,0,0
NB_c7510cfd8650508000194574991f10cfe5be5b94d983d5ef27ce024c1f3a13fb,python,10,10,0,0
NB_cbd9ba713da6942eea185cb7b9a5805fbf171000e5658e1bd70cee72d92a0098,python,55,15,40,298
NB_dc9d3f26257f2c258506348dad1bf9a9c8498a29ede3620a9eda61fa306467ca,others,121,112,9,10
NB_2edf78dffda80373a3953afb5dae985ed43189ae8f88ddab4e4d9648a61d6623,others,63,53,10,32
NB_d1487acbea58630a035ebc5bb8616499e6a416d330e45a88618570e4560e7440,python,11,10,1,18
NB_8c1cf7bd68dc79d8f5bd91a5312b5d68f6de9018dc01324c92c86c76fe83847e,others,36,34,2,2
NB_d2bf42897068c2ac144a64060df2063042f1afcc288595cda4aee059e71266e5,python,9,8,1,1
NB_6c4f7e3c9e28de9671b244b4b807021cebb2bebf3278630e0304282817875c2f,python,154,51,103,784
NB_46990807ad92ff9e4542e12d0485b1b524722bc45353c0c79677676b38e280d2,python,10,7,3,5
NB_096ebf2be7899fd19d9bd807ee5be49e684ce38e573954cb4f2fd848ec989731,python,38,34,4,4
NB_d3b511ccc085667f295ccf0a5f079dd587f9881150e3061012bfd9e64c9180dd,others,72,37,35,41
NB_3eb52a95353cc35554f6a96a1aeaed3e2a7c30748521c9420665123a592ac61e,others,60,27,33,867
NB_d76de2a2502876f55c45a7f69e4548a0f2847d554ce97f073b8553412b5703a2,python,9,4,5,21
NB_e37bbac77dab973cc95741a95afb39e0309e67a13e3859864b7922d38c2facc1,python,1,1,0,0
NB_765674e650b3df0f2e0378b63db9758f8d5b6533be29b4609e95a040b8493779,python,44,23,21,150
NB_0398c34c721eb75fa629dc123192dc990bb92ecd41e913446ca6135149158b9e,python,1,1,0,0
NB_1afc7e0f0ccc7a28fb768e584921d23e1757703a08ba3512dbcdfe828a713b18,python,6,5,1,46
NB_a1ba26b283e22d073d1b6e05b655f13b1de4a4a2e4783dcb16cb7f349a8f1ed7,python,22,17,5,5
NB_c2a79afaa501e87ff45787dc8f774417f9378cd53514d849c642940e01910fde,python,11,11,0,0
NB_41ff35d887fde5a0fd49dfa74ab44966548d26a445f68edba9ce5e126a235e78,python,18,11,7,9
NB_9fcae417aa5b7c1160fa3b76b5ec3c49fdf9675e61e52f9535c34e888da219f3,python,12,12,0,0
NB_b2827fc09d3532d750e95a35eb8e2bdf667590ecdd8a62575af2eac0747d1a06,python,16,16,0,0
NB_1c1d01e57280a56755e5eb5fb2f6c012a87d0a4fde451207472b08c6703cc6e6,python,125,102,23,23
NB_388d230f7d280a99b17c480ef0c90cc6c547961fa4f2e06a15d6e5ca0eab45ba,others,54,24,30,150
NB_d1f4dd9d69ebc47b3a97244a107400d36ed3158002bffe2b0f2f49f3a9a4b3e6,python,125,90,35,40
NB_7b2ca85902c624b37b724e24af62f8c16db345437faf866004ae545252b2f9c9,python,24,18,6,6
NB_879e6c3b9fd2b2a9c4ffe9cdf42830606330c22293e4d2061aebffdc5c5a38b0,python,6,6,0,0
NB_450d0a86c692f84cbf10eabda02a4524deb2f1904761ebaaeaf716088aecb422,python,27,12,15,114
NB_3e147a071bf53f6bd250f641a2cf983baef116bd0eadbf536e0accdb1cdd8540,python,22,11,11,19
NB_0f73c10409f3cd785b9f13cc6a4f11b0da210967e7f3dd0c8c7dfc7f7d8d7fdb,others,94,55,39,44
NB_a14e2c09df4f57d714a5117311c92cc02784ec56fe25ed3f130c5386ab8c0c84,python,36,12,24,34
NB_9b02e384ba24e022ab08ccbcd3c1273cb8fe67efeff1b449fe0978747f936169,python,26,26,0,0
NB_1f8d5c674799b7914cd02bd2bf0428402dc478eac00a05841baa95920a7562f9,python,4,4,0,0
NB_2a7cf3fc649b51bcd81ef2af47dc4a85f170510079ed413b2ba428ed908be17f,python,10,10,0,0
NB_e39bccf2dc0d5d87a33a5a47cecc2bffeeb219e39529ad670308e2c1df509d89,python,407,366,41,41
NB_5a25c20743d354672cb3e34626b74d546ca2122d91a93136584b128c4e5ebc3a,python,12,12,0,0
NB_8f3573a1d7b1d001f99ec87e3518be7a857320f7b0c40fb4024728296c4b33b5,others,81,48,33,37
NB_e3723aebdb34cb5b73039a601eededea1791853cfce3a8946f13ec407740f20c,python,178,137,41,41
NB_4e2b86a73952568e8d84f06827288a1621a4786f2a98c9c9cc65fa4c51a198f9,others,78,45,33,37
NB_ab92121e31ab56b765e8ee69086a7db2774e192dd5a3d63f273f5a424ded397e,python,4,4,0,0
NB_14fc20a1c0a41a6fe126293c3324eacd35595e11a332a762fbff1f4e5f23e72d,python,25,11,14,275
NB_a86dd913a82173b3649cb69c4405d5cb7d2c52b16a898211e079bf8e6f196c3f,others,20,20,0,0
NB_5c1a9017190c0079e5f1731854ebffc966e98837c1997b63269d04088054d49a,others,0,0,0,0
NB_4576dc2b5282abb9617bfbcb9f78e9cac478922968bf84d0658345e99f07598a,python,9,9,0,0
NB_5b310fefa25f8c4675cd1cdfd512f5c9309939531489307f19fd28799d7a60f5,python,23,11,12,38
NB_ece5c3248770f6c812a27a0f98869d2f5b25f9a85543c4d8680e2cd93f2cacb8,python,1,1,0,0
NB_f8157737a17d327659d0e1f1aae7b03b4887819b258ebfb5dff39618c28c8e3a,others,16,14,2,2
NB_2e57d758499caebd1315dbe4a32115f8144dd847c447d5de7e45693b6d8d2a2a,python,46,24,22,64
NB_124ca9b7d4473c341a619a96a7752e2d7f10c90f93e26c54cda0face9674e548,python,26,19,7,10
NB_b0c9f1401ac3a8197302e58a8602e832b4600463f9dfaae25e20b0feef5c7570,python,27,15,12,93
NB_9a3ce21549f444dc2accd51e861a6d17988bda865e116dd3f80ef3efdf9dbd43,python,3,2,1,3
NB_747e3bbddf2ceabd15c361275eb1e03e141fba32b1abba1e0b0f9bf443f45bc2,python,24,13,11,37
NB_fcf7e65487278f15cad7d91c321a49beadee80be767b10461857d048ed8fb0c0,python,21,10,11,53
NB_e391ba767b9c0dcdf509df587defdf6134f75e089b2ec884ba128b2ce8596498,python,110,110,0,0
NB_984bc992873cfa1e974290ecf0d15f89dbad751184e3e82d4491b14cd5ed07a4,python,12,10,2,19
NB_a5e2d87a6c8f44858ab754d0670e2d0939d78905b5a2a3eebb5aa745d55c6d42,python,6,6,0,0
NB_bb9b54bb121e181c74014a3d7f3dd38b6c1f26214b816a85ca68fe93de604830,python,11,4,7,61
NB_520e9dae6ed7970a7c65e46f8374bee5d211994ccf8ffec2159253db12f3f536,python,5,5,0,0
NB_1b424ad6148b09004268ad0d7a11800569a9b8d4e1ac1a7028ed34736f615592,others,38,17,21,21
NB_2db91341d8e0eee11cf0fa7ca5963ebf725b6b7315575c2a575d926e87e34579,python,24,22,2,4
NB_16d74a69a40604cece53510bc1e1c1f3ce88ad0aec0a7a6a2a0f4cddba724845,python,45,18,27,557
NB_42d3981fdac5c004d87097826dfa7f08bc11950d2722c10fb9b9821d4d90fd01,python,36,18,18,240
NB_14b15b18b47e2c6835afe3a2603af3b682f85563d2aecd662ade93d2634ff874,julia,42,33,9,9
NB_0226c4b5481147990d7d329dcbc5d068b1fe89e2f8aa8daeeea7160322154a47,python,22,22,0,0
NB_d9b9db80c07cda91af451acd21e1ff82b48a31c479c16195e41d293541745830,others,6,6,0,0
NB_d5890eab6e2800fa8c4c9829988e264183b7b24906a7e1890393ce45a1225b70,python,5,2,3,25
NB_41d8ef1bbf1634be7cb2cef01d3e48695bdec6df7dbfc5627e36eabd1ac0c73d,python,10,6,4,25
NB_ad930f68bdebf9c2ee7a101c06f584229d9c15c5c63cc1944260ab09713f7fc3,python,5,5,0,0
NB_78243070ece139ebaf0b7c33102a7210d260f24221453c05d507456f27700d16,python,35,19,16,16
NB_06b4f77b27eb195aaea0a30bca607108ce2756816b13fa475d400d7fe6f25501,others,48,23,25,88
NB_92d6a1eed97afaddb033252a715067760f565133dfff6a254d8d34a16ae8ad05,python,86,70,16,18
NB_a548012fae92a13e7aada00e3ea346233a5dbab0597a489b564910faa85958f0,python,42,42,0,0
NB_31b459ad17e506d5ece70cb2f2dfaba101f239f4172fd32042cb888e8471e83d,python,65,47,18,25
NB_4ed194dfff5d935e089d5bb00f079991b9973ee14bad769ece73305854b7ce7c,python,39,35,4,16
NB_d6402ab870fb79913bb83ae997a1ac50509aee4624fb913b6ab5f9447b9f6d6a,python,15,9,6,8
NB_012cc103d7729afa61719125ae37da5e0ddb310bfc25a7ff1d42a52a513ae603,python,33,33,0,0
NB_86626512aaf2e6be3625da315c05e4782e01f9d3d30ef5a13089004dee6f7049,python,26,19,7,7
NB_fe4d87a43529302910bb24a26a4180c122a5267b55e8f4e2d2d2477bf904850a,others,19,14,5,5
NB_df263586f9e6e8bc72e8a533a60c215952ca6192c0977a14da6bf2bd48ce6b88,python,27,15,12,108
NB_3766f91de0e9f67503c358b96eb5c7bd6faff2a64fb49c84fdaa5b0f4015ec9b,others,10,9,1,1
NB_6d92e39855c29d57f12fff055712161ec6c97e25b8f58d032d64521b21ab0a9b,python,20,9,11,131
NB_5356ca5bbdebb394541b147fddc38cb0648276111262a78a205f0434e9e7953f,python,39,23,16,48
NB_de58cc92c2f9105252eccd5b27a93606e063bde32873f31e9421eaaca9b446e8,python,18,12,6,17
NB_0a7ea3a817e57351b334c08cac501132c3d3e9508bd17aa04635946495c385dc,python,25,13,12,6
NB_5465184475b546c5a86bb2e96df26d5685217a9893eaf1d0af50da188229da07,python,21,18,3,4
NB_deaa544006d4253940847dbc41e072deb68f0854dd3e9d849b5d926fef974bda,python,19,8,11,81
NB_f48c529399bf4ece62272829dfd10250cf1ce5b41bba47cbdb721f9242626927,python,258,209,49,62
NB_44d716213f7c88c8981ad32d0ff2b409f62bf129894a7500838417a640ad0783,python,30,22,8,8
NB_db675132d0b298c15738a4a3df4e2b67cee8da8d803d4073fd460a91db52fe09,python,133,124,9,9
NB_d78c36811ef3f6fe72cc0e7b6a5af1c083f7a3934603d4225217130816003afb,python,64,42,22,40
NB_26cdbb790970bba3a26865865531a12482a31b44d095999d5b31c2a77ba87a55,python,69,36,33,78
NB_72f7adaaff774bc1280ac2c4eed81e7734073acec8078c5a91f9f3a6bf54317b,python,56,16,40,52
NB_9c9f2e92ad0a13ce2bda15f8c40b5c854cbf66ae33f3fe4360fa7da5d15b19f0,python,6,5,1,1
NB_5d27aecc2e53365008f17a164591e1cfb01d4e10ea5e670aaeb6b32ebff893f7,python,20,8,12,13
NB_6c6d6fef032be172bd825886b88e363082c85a8ca3170f430747b87b35f24482,others,36,23,13,24
NB_f4d955cdf9aa39db1d874b818d5fb2d9fb0821d30959a43adb7757003d38efcc,others,51,29,22,23
NB_f08470e6ec6108a005a818e544757fb29468baa62147ab70d6bb805cc53d71da,others,2,1,1,1
NB_ee907c976806eb6ff37631c40b56ade418e8143b42806af7d8cdf3f16cfa1a03,python,15,9,6,9
NB_7b55faf3f543cf6eea1a35442222df05e622b43729469bf216e3f67418fba18b,others,21,21,0,0
NB_5c4a55b3b2fc771d3085326b474db78c100aa4caada329eef3505be0a742b955,python,46,46,0,0
NB_56da42dc64cb7bc8445f0af82146030e425471c860fcbd6420371276c9bbdd55,python,8,8,0,0
NB_915f3214fd69dd104f616aa06bcd4b8add8d28b393c087408efb76453622c7fc,python,56,55,1,1
NB_1cac84c65b16011762c0269f0e7e534855d188288661e8db3e29633d716610ab,python,40,18,22,59
NB_ee773a92e7fc19a0a1f6cdd8d4dc0baddd5855ac6a2331a03b4e5002e8f8e052,python,11,11,0,0
NB_34ed45a8be070d24ed3478b275d1d9c666fee7e18c18833aef9c9570d918afed,python,262,144,118,377
NB_557d0c5f1872cbc1e7f4b3450fcf1c6d5a731c6517cfa3f1d763fba01931fa3b,python,14,6,8,77
NB_177bd737300d261147726e025da04a56d3e0affe8c3bbaed22c539dfb98f266d,python,50,21,29,178
NB_4ca06c2c03109282aaa1ddbc40cdaf12019cfa4e258aaef3c90967ff2f91b6ff,python,32,24,8,8
NB_c303ee3eee252cd0082e3006ad500201b59b79629b8a4e562c640d3caa1dbec3,others,7,7,0,0
NB_b43ae7351bc2163f245f783ca765b7360a0664f8fa73475dda3928debb65f336,python,22,10,12,190
NB_486acae4a298f8abecfba159c0c7873b87fa70d062e284fde518e1afe4e43ff0,python,11,4,7,61
NB_6f9fcccc71450abaaa7cdc5022e3aeaf711e0178cf14d4b41e92a30a6fa49c15,python,74,70,4,1272
NB_eedef9884044b761ba6f75b527483db8fb5f905a0dc1e604e9676102ba82b4f0,python,45,22,23,162
NB_a475dcbd630bb49ae45af850fddf08b689460a43abff365cfe18761603ba0a19,python,11,6,5,7
NB_a3dceb72728238e98ad9aba3f890dca46632bc701b9e4ede1a4dd400bd1937bb,python,46,41,5,5
NB_1927edba543efb2d1fe44a7523d66793d8ae1af3848a2963cbc4c37e43c9b7ad,python,2,1,1,9
NB_928b4e1daa0e05caeca76bfd0a6f800f1d673b78417fd0c7dd8326b9a3796e9a,python,18,8,10,165
NB_77aa910893deb9a2c31228a60d11d7cbc7cd5ec5f97e350f59531795fbe58e8d,python,10,6,4,10
NB_2fd41d7d81256e9f180634c46cd2e048e71fef6b85e107f0813dd5bfe6ba824c,python,11,11,0,0
NB_006996ad726af6c9123c11bb6b203347362c6d660297ef5174cd788ab5ebf5df,python,7,7,0,0
NB_5e670e9adf9d0dc5bd942d00a7ff59d87f471ed3a6598576c49ee0da342a78b4,python,71,42,29,83
NB_b1fdbe10f73dbebb217226bb6f570462aeff5813e6e8262a963d30a524bf5c7b,python,32,21,11,11
NB_843308065d07e7afc6ec17f48f7ec5efd354e1e89b3f4da9e5596666c69e5789,others,9,8,1,1
NB_e20bccacb1545fd8317d6c59b3de2be923d4d03aa13310391579b1dbc05cab44,python,15,15,0,0
NB_38a9169f3fd0b01478824c013e9acff2a0ee23b52205dd22faff4288ef2320b5,others,99,83,16,16
NB_cd3a8c0c2107df7f8a226f2dd243535d6b93f0c3e8bae3dbffa6259ecfae841e,python,26,26,0,0
NB_bf878c36ab16bdbee7f1f8cae102350e4edf2470a2522f37396e26443d61af96,python,62,41,21,22
NB_9225755224d4b008664f6e7e6e382c6c39b97e99625eed0f77dae85eead55c03,python,3,1,2,26
NB_a29d61417dd1bb4c9ef737470a4c288cc42c47129c6feda287f33a237c641b21,python,20,9,11,100
NB_cc804cf71e32bbc9e83e06c7c670f1ccf6b424b70603254d7068cc449f6b48b0,python,6,6,0,0
NB_913f3c70a5dcc0b1a9465d8d8f43677307251ec22339a2793de9c334548fb697,python,29,27,2,2
NB_cd2750c8cacc939a82c3d0a70df8d2c74ee4bb7fa04197f548c22b29811455fd,python,23,13,10,36
NB_96c6d44ce390832c6f3fba922a4c7dbcee3e577842988a64ea7e191c90d8a263,python,15,11,4,19
NB_140455e57abb0257371f629caf0b955a83f7089516c1d49e791ed0d57d8b36d1,python,15,9,6,9
NB_97c1a35a60bfc95060c65beda75d0c19e0f97ef55bb802043e1a25cad4bb9db8,python,109,92,17,17
NB_817389a8575f2585b0c7d5070bfcf977f0f901e058a44146d4975d6af8631e54,python,79,45,34,129
NB_ca243380279b6c092ff573cf97f229844c4c36b55ede1cb567a4bfccca8dbc82,others,52,30,22,23
NB_affdb582c9062cf13f982d8234a5ac603a94fbddaff541b473ee068737ed20c1,python,8,5,3,3
NB_5511948756b851830a21e6767247ff6327b1376e0125ff9a97fcaf9756b2e352,python,17,17,0,0
NB_6ae864a54d6f5f12f8f03594d09375fa32c06a72259f0946b1f16696cd3248f4,python,15,9,6,6
NB_73511d06f29ecaa867bab699b3352a99293cd3dfb00e3fe63db383a75ca41557,python,18,9,9,21
NB_e66b9682a852b2815aa89203323efbeb7f732a0b1d17f7a7c1123518633c9cd1,python,4,4,0,0
NB_af35ceff95a585e1be3fca592036439d07805b2882d1ba1810c1b46ae5bc0d70,others,23,21,2,2
NB_c730203ac66ae7b1433b002aa2418ffb7268dfcb1771208346472184d5006cba,python,18,11,7,33
NB_3a6cc368e6aed63d5bfe9a2e92fa1aa243068c124b5d9da6b0512876d3c68e59,python,20,8,12,187
NB_b080a96aa436b13f41fbc0b9b54132dcb20b3f3abb2767d5f39fa3638581669d,python,21,21,0,0
NB_f092b3899d234b3e1ffd94f7b31f09a7dc9da0d9bc3ed2d326bf924480205b0f,others,94,55,39,44
NB_2afe99fe0730275badd4b1ffd5c1178bd4e07f4cf47d75e02ed6bdc8e9df2f42,python,32,16,16,38
NB_daa8b76f383820decfa88ec777b77fb2ebffccf9a9ea2ac6429eec4d04eac7d1,python,20,15,5,5
NB_ee35a0006fa4c118a75c733cacc366e500ced4850bb3a12bec2f7dbd49d3a7aa,python,190,141,49,50
NB_46877a61383d46d5477a3488517f7d96b03186700dca0cb5520e0c6eabdc1fce,others,100,38,62,248
NB_f53a5fea0a93d84a20b681c31fb21099f41516e29a9ebbd1ff20b06823be5598,python,1,0,1,83
NB_284ce8f0a18dd9927b5b580a5a2c503c31c91b165c2fa313ba9a10a500d1bce9,python,4,4,0,0
NB_6fe6c1de1dbaf0f2638159b931b1dfd7727111bfacc6c13a1c4ad68a3f598056,python,19,12,7,23
NB_0f8536fa0373ebcefd2daa430b3dd28793d14177dcc0a6164f04b082c26aa45e,python,66,38,28,27
NB_e2b20500792538bd67da8b9cad86e93ccc0edf0d099d6a74056410d822d9db00,python,5,5,0,0
NB_07d84cfa877fc98cb06afe87bd8a49d67d2d6e41d96085245998c17f454c818e,python,2,2,0,0
NB_0470dd16e687a92fc86fe790d76961e17c6588b3a0aa94d929bf62720fd09bd0,python,8,7,1,5
NB_0dd3a9da7a6542237681d1c2c5b1edc3c2d4a5259c017a7dc81b1749ba9f41c4,python,3,3,0,0
NB_96745e52147ccafa00afbc55afe0cbe0ea8bbbde2b9de91b0775d6ac9cf5cb43,python,59,41,18,19
NB_6b03fbf9747a0f47c3e4df4671b93faf94cc5bc57af8e859e3bcb5cfe23a6cfa,python,38,26,12,38
NB_4beec5a7cd211fc8f4360eb04d816c6ebde1e540c33f29bc5ec65369405af8dc,python,17,11,6,15
NB_c742430f25728d0b9e0004ef8b7d2080b3438cf11c523c196e45c3bc08a7deab,python,116,66,50,154
NB_79b2d0979906536988ddb833a4c9019da3d935a9a267b9bbedf4f3a794357626,python,32,18,14,128
NB_65778d2349d814eed0b2285bd52dada598e5d1e0e16b47c1fa55371a335fd2bc,python,21,11,10,11314
NB_b0bbba68667a02a8a55843de5ce0df2014bb9a6078489511e4a3b38e3b7a4979,python,46,18,28,467
NB_eed0c5dd540f21558e7aeb1e25d89094ff6e43ac38acad2d98162e2b738ff6a3,python,33,19,14,165
NB_cbeaf99cadc0b074946671468a4fe42ad8fcaaceacd6322181a73cd2b1b65ab5,python,14,7,7,81
NB_696c3cdcf4215c7d9f909624122274cc383a54e4844e257ea2b08d4b8d2b921d,python,25,25,0,0
NB_822689a241d543a0f952a6a01d343c7e7dad971d82a1303bb84a2ee0bd318aaa,python,28,14,14,157
NB_774fce8a886857ba379a9dc5405b3c9b9ab767e03a1ef352d3b7de21922a23a1,python,3,3,0,0
NB_7cebe654c74c5cf6d281b43d22af18b6f6f8b5b27fe6324829d3092ab7cd12f4,others,19,11,8,8
NB_8987b12ce5ec308b052c83b5357408a90196a5958020e6448a0a39b734f90900,python,65,26,39,436
NB_e9d62840cf1ea20c39b430fc7d98b0adc1b808d4c10c263fd57a7589b4b98941,python,7,7,0,0
NB_e8779ed45ac3a39069370c6bab12a8efbd00bc9b3ba0ce4735d7dfcd89d94d16,python,96,45,51,720
NB_769fec6c9d63baa5f86c7b8aeb4af50cc68de6760aaf3a18d2a067e168759872,python,11,7,4,25
NB_6e5c5b9589039d1475d1cbf2264395f13a8dd4c0bc377509c1ca77e0685ff4c3,python,26,12,14,27
NB_cde1468d4d31f4760570d3657fc3a4cdb2fdbd4e80afdb02940aac6b8a618261,python,21,15,6,6
NB_01d1f340f3cf7d0c59110893f6b9d45a4c5c4b39b047763d831cc0a5b37b7686,python,57,46,11,15
NB_309e0917afcd2e9000a11e92f8190316c874b25dca84eaf6bba111b90e10fe27,python,16,16,0,0
NB_a849042030f11fc5cdf2425b71e3edb7d572ff9906a92b0a52301ee6def21553,python,56,46,10,10
NB_3293ba840f7ea528fd242b14d5e535da82a7e10df5b7cfdb265ff23315b36d00,python,3,3,0,0
NB_447bc506d021f230a8a5f132985010f5ae07b4a95c5d63debe65f5483b3a88df,python,3,2,1,11
NB_0fa07339f39cc1f9945b1e352e52654e361647d2c75bb6f5e3e820f5eacf27c1,python,2,2,0,0
NB_083dd6a6f31fd5c586b22407d1b5c31dc9741d8378630bbf8e980d22800ac874,others,94,55,39,44
NB_ecc15c7b2bb519a77e601c3b42486590d2723d8c819e686b55c627574a74d16c,python,10,10,0,0
NB_08c9fbecb0b915a3cf7d8ef0a9837ea217106e150dcdcafe09e95715ae8054cf,python,89,58,31,31
NB_7c2e08e1dfcfee80f608f0f2d1d9875f83fa8ff858e6f1589600225a670e0ea8,python,21,12,9,110
NB_929cf2da60430cba32b14b588f9977fce47d213df1f46a86835c90842a0b7498,python,3,2,1,3
NB_3710deb4145c8313caf73a6e92b301792181b5339580ce7e05da892f916d70e5,python,41,36,5,5
NB_c781faa1c65117fe42355f5392a183e137430a6696c8c5d412a27b6afee12672,python,18,11,7,12
NB_25983b771903dafbdb5b56cacd4f6e276d5dbba63c3e3b88761ec5696109e273,python,10,6,4,4
NB_8638638516f1105b7c26236b2485092c7efdbed546dbc76f18f62e9d61a2a7ff,python,12,7,5,37
NB_6e7da581b6877ea69966f7be6cd8acf27fc28473bbb70e96b3f6432b4fb43025,python,269,153,116,306
NB_7a6fe65e7b86303d69d87cf88b6bbbbd7d648064e81af14296596083d1987437,python,18,11,7,15
NB_169537e24671e17e3054fe979475a65fbe31cc9e5abf49ab959de732faedc139,python,217,101,116,1683
NB_dadc7b7cccf7866a249cd6dd599337aa34d837e8067cd34c43c5f076ed68237e,python,10,10,0,0
NB_db2ed39320314f12f8d9090e773e7e53ca1dd1ff72f19f0bbdef05e195ef1166,python,39,39,0,0
NB_614d78f11674b16241af592cfaf2d1916bc442b27003e526cc2588dcac529c93,python,10,4,6,17
NB_9973a2345d99b93365ed87160b27423c3a908e364c8ee6c00a510040a43f4f27,python,16,11,5,5
NB_f5b15d5a1da65e160039bd952b337ffabc11ba204a6a7e057137da3d44fcf3eb,python,23,10,13,137
NB_f298536eff506b249d1f624fc8db6be4a5072172bba7b1d3e7eddc75ca50d974,python,16,16,0,0
NB_81f9d06c8f22c16762009bd4dcaf58bb9aad3e04a751bd305470c3e8ecb5a649,python,12,6,6,51
NB_15fd66895bdb472e3c7cf7032249a64747ba0aed9ea8b9c1123776f6c1bfe448,python,19,13,6,6
NB_4a122f34987b2d691bdffa4c54e52ff4a8af3d7e7cf679aa66925002d68c062f,others,0,0,0,0
NB_bd1dd6f05a5bf074b041e6c97dcb85ae7d33e5a07bf6a875ce08b47c475504c0,python,1,1,0,0
NB_1a3119b1669df83226c00219c1a503406d6d38ddfba3e206d6426ae02e1b9de4,python,24,13,11,37
NB_d0f4f53ea493d796d6fbf24d68477b23519df5825dc5a78a727532438e808c04,python,11,6,5,12
NB_f0f727c09562767ae684fe9b172755c35d8184fb194cec93be552807db68a25b,python,37,21,16,24
NB_38879e44a2b347935f0855a5fb4fc6a771c8b43054b380c49c28d9aea48552da,python,31,30,1,1
NB_fef983aaf68e0883aa3f21cf31ee64a77bffe448813260747a2c64dffe5eaea7,python,10,10,0,0
NB_fa469419ba4a770eac90e3c8d3406d766db0d23a6e6e474034dade6d3877ab76,others,59,44,15,17
NB_57f4d97d361e52c1b9de3244004ad2702913544d4e103156acbabba33f14ca60,python,14,10,4,8
NB_67981d439dddd017bc1ed582e71b8bbdad80191c817753241b840c2613ed417a,python,39,25,14,23
NB_02bc45442317245caa5b884806ccd911ee4d39c6e85e4c5deebae9729c9434b3,python,8,8,0,0
NB_e5df0f8646fccdf979122a0ad1e3825851f29db31dc26f2b2cd9ec19e372f22a,python,2,1,1,1
NB_7bd70213b2756285425bea125b1558bbc7bfcbf4728aff657ae61f345eb56e77,python,128,96,32,98
NB_1a630290ef2e92fc80032ca0bbfe166e2118ce3830083ee7742aee1a4a582cb6,python,19,10,9,122
NB_828f0d808a4d1e790cf2249e02251cd97b1350324efea82e7c8c0bf025625fda,python,48,27,21,29
NB_15c7bf6e9d5ebd92184326d2f9406cf60fef44f4536dadc86cfb5989791c7309,python,87,60,27,62
NB_7272fc1810286624236768dd5242ac2e903090d560bf085b6979e4d17b528923,python,21,18,3,3
NB_fff34a3d7eb96a57d1b42026c421e1348d7fd8737266f2005d8bd9ba2b316510,python,2,1,1,87
NB_5002aeb53214b0bfbafd73de2c9c573cbcadf79cd09749ec4c9a729695ef24cc,python,7,7,0,0
NB_d7053f1846dfcdd061337b54f5a500193c9579c16cb7f3a0ad0b6f7b02773128,python,14,10,4,10
NB_a03f2afd40dae9485dcdab1f09c5e8f6a5bee0b4e5178d89be0ed6bd9c4b6207,python,32,18,14,148
NB_9f4571a9121fd61c72d12d2e5f8195d917b9487565b5ea6e2834bc43ed47b2c1,python,1,0,1,126
NB_3b426190f62ea95ed6dd14f7b031c35e769e77b9211ae79ae000ef08db7782aa,python,33,19,14,165
NB_2015465a25ca332df46f983e99bf37578656baf6ed4af106fff30f3d169b5c7b,others,45,42,3,3
NB_7f35e45cfa02d3f47a11bfa5fd27a218d7f881ac399acb94d561379d8d4ccc37,python,31,17,14,51
NB_409c032ea4f89e106d4eaffb533bd6e6a81f9c4e92a9a063e3896d3a01a4a990,python,13,8,5,5
NB_50571126e3c2698c74c7c2839fe5076068cfef603638b60be61bdd8645cebd72,python,14,9,5,15
NB_2f1a870be222d985f0f274502dbc75192f92eb1f8d21719cdcad03c07e82dbc0,python,45,18,27,223
NB_8bae879060f7e327349bcf76e5b9cb30cb088383266bb9be2199dc514420a0a1,python,16,7,9,119
NB_38a35c451880b32361827b2137fccd85e3db28cf36c53c7658abd1e7a2d52f57,python,18,14,4,5
NB_e98d54c6dcaa15aa0ed743d3a0472191b7a41ec44e8495a5accd1df665a3119a,python,49,41,8,8
NB_95a5e6369c381fcec303c8272a3c61418fde48f50ca4e1949f1fd09a405c8879,python,2,2,0,0
NB_814b1aafb9c18cc42e8c28218d5ee486e92a9cfb9302e0206d33a11192ee8046,python,26,14,12,108
NB_6ca28e2cb8513cdd84ee01712dd8882861cb8a743f942850d4b0fb7e811843f2,python,40,21,19,176
NB_ae408b4dffe1e57be31f98227d86b9756f087ae198b19487ed2e7acf74ae01bc,python,12,6,6,16
NB_9895de5427d6e63a6051883df0c2d163368ef8044584ad4995506a32012e24de,python,8,8,0,0
NB_9ace3a55e8a4155dc9bece4b7e6e76ecf02559d10ab3ff909e38325df9b68de2,python,25,19,6,6
NB_ac9c9e7a7899f53c7c9faef72c7c3d69fc2931a5c22889a8b8b44e9adb21f94c,python,30,13,17,48
NB_d9534cac2a88831e3e9c5e0b7708407f54947f40dbfbc23dc65c5d15216ecf3c,others,15,15,0,0
NB_6da11b1c647870dfe5132c97b6788fb30e1ac6544e37135ef1048e8c85ebc484,python,45,18,27,223
NB_5d39112773594628b7f134b2764658d963a8a62d98d05a8929f964fde987ad05,python,82,50,32,52
NB_aa796a13a3a9e1e7ac53c0953ebbd2f24f8239e22983597dde46249d149ee1ca,python,33,33,0,0
NB_810f03c42dc0bd0e3e19e797950960d37ec72669c999c467260593fe40500586,python,9,8,1,5
NB_bc0a922017a9adf8133a144517930add9e413cb13257f860e0b3d8193062cc2f,python,2,2,0,0
NB_542d8998614fb914c7e7c0dfaf7dbefd3d9401d2983c8f92f81ff7535a189023,python,38,38,0,0
NB_8d2af3a6f0b39ed12bb57156c043a4bf8cd836155e1b70309e2f9eeab8a5187e,python,42,23,19,126
NB_bc182c0632937df86901a6ae33cb76e2ed101b9494cb092a7a5dbbf5864d17ae,python,155,155,0,0
NB_5e14483d18939c201226d683ebf129616b122abb858bd932cf8414ec2153b0df,python,32,15,17,109
NB_d6d6a1eaa2e33ba38abfa6966f659f50d58fb40ec3028c87bd813d75cf0e5642,python,34,34,0,0
NB_d9be377626a4995846976daea98c8269052d01d3a304a636ef715fea238fec71,python,26,18,8,8
NB_ea71a6d1831800e6f6f3a359611fb541ba2ba507d138ab5c5ee8757e5f0914af,python,30,18,12,136
NB_12026790adb9d92bf9a5e522ef6a5bf2f25c9e4189bb0b76214a0a1f3f1914a8,python,29,21,8,8
NB_574e86548044d8a54f8599d3f50c432a1fe7619c017fdfd5d74f77a3e9a1ab5b,python,14,12,2,2
NB_d7992eb66cf14c206cfd009eec9e240fe82d85f63d67591859d7bdb508bdb229,python,64,64,0,0
NB_f519dba68f4400dd80ffdcd7cf259ca697ea8e5177a0e74a30892ce4299c6d9b,python,34,33,1,7
NB_efd031946893b1f1a230e1ec01f2771c98a44581ec47ec1c3e333c5cc5a7fb14,python,16,6,10,16
NB_fc79927e330caaec4c2aa821ed883569a0dd297a14321cebd1273df9e26b51a9,python,39,38,1,1
NB_54bfcfa0acc123b342a8110b5eb56eabf4cf63db3f096bac52bcb5794a4a169b,python,35,21,14,33
NB_a68e07fcc5c034109bfe5c019fe08202313f66d0c833f6cdbd14fa150be36c09,others,26,25,1,1
NB_372ce30c2f38660a32dea5482b1e5e0a3167e593c58d9f1de28fafd4bd1cbc0f,python,68,55,13,13
NB_311ac5c736718bc0520288be29c18763214b34b7efc12c945f1073d625cde0cb,python,93,76,17,17
NB_fe29a4c65914bdeaec1aae4b7379268b34dc4b8adc17bc6b44d22eaae106ff38,python,34,15,19,12963
NB_196f9007fa4a92210c116925f742d04c5374dc2d4f768acbed67375e88edae4e,python,6,3,3,7
NB_30da94f5b936b87c22fe8899a1ea398b28e3bceec141d2cc7f924ac05950a42d,python,13,13,0,0
NB_624dffc4e888e4e17abcbbcab84451206106111f1e540a438f20cef3cc9a575f,others,47,19,28,100
NB_a05ce8ab9d653bab793b86fb72b6c34e77bad442f32a60dde4dcbc8ce3b5dd20,python,8,8,0,0
NB_8960c2c48412cb933ec02530902bac04bb03fc63251a82d013b0039710a2d35a,python,1,1,0,0
NB_5e63d2e2fd8f6614529b5d98dea50acc3617f05ec31764dfaa4c18a92d3bef3f,python,23,17,6,6
NB_5559977de1209a3b031771df8b5a2c8d3790eb073393cbac542b25d6cd7b33f8,python,24,16,8,8
NB_336b9f5ce19fc1b8c643adcc615da8bdaa396b1e4660b4180d12264ebd16be84,python,74,32,42,61
NB_1b0b30f9574de9e5d95154e1f78773697562fa78e37fbe4cdc0bb92307013411,python,3,3,0,0
NB_78dbea99683329571780ec1a9c6707fa189c2a5743af22c9dd72c8282921c34b,python,7,1,6,192
NB_5bbb119c86ccdc1378b3f40e941c855f2c4c3b80b89dfabf1171182da81f2bf0,python,31,17,14,22
NB_e6c67f16f3d63037ac267030f58d2c3b528a2ca8f8aba8f67a9aee63812e51db,python,28,25,3,3
NB_79a5bc68a5610201a017133712bc5228609dcd11c626cfaf7beb890d96f6ae61,python,94,77,17,25
NB_74e86a33bd2f6e66b7bcc578b29176ad042d013c90884e4ae9313dcb64a95844,python,27,15,12,33
NB_643b70e8ddc4fbcfb57e4236927ca6ceeca26b214e81e9d33aab3143e906005a,python,32,32,0,0
NB_6b918fca022b8b1c9822c428b736e8825a01aba9288d79a6ce93f3ed39ae48d2,python,11,6,5,26
NB_cc4b1455786f50c93a884ba9f6896a2d9f61bd1a381d2ef1e8439cd65be8bf9a,python,51,42,9,43
NB_13db0e1f74caff430de5fa7a2cd47cafee47509881ddfb66bd105ff9ec21296e,python,38,38,0,0
NB_7cdc9c6d42ce6f27f7153efbe26cd29c85602a10f0eba99cbc19538cd03e0453,python,70,30,40,289
NB_4c8dfaeab60023e31a50cb3a6b72ca92709579bf81a79fb17c6e84f74781bae9,python,8,7,1,0
NB_ea562cc0412a581ca8ab43ada4c9fa58a6809a3aea364075ce783a9b8b268697,python,9,9,0,0
NB_bd80d05fad5d7734248295ea4664fa286fb1b72dc1dd65aef0b684503404f555,python,15,7,8,13
NB_620eed8ef10f8a156d80ce46f3bb08173aefca6efce4f9250c109eb84b3c3d0c,python,51,42,9,43
NB_43f92479a7eacb9a600d2e3dbb4270eca8788a180b14987ca4bce7577c85058c,python,25,24,1,1
NB_ef08221736d45b88f466d97f88bf3ae9b695e084212646afe5a65bbb93fc8359,python,38,33,5,5
NB_fef8395513ce045f561ee8642616ba591337dd05aafb2d3b58d856b756fc7bed,python,113,82,31,30
NB_09b8d18a6e536893f165d6817b37bbaa4e61db1a8a925ae146374555501e157d,python,12,11,1,1
NB_4eab8952326a6cc13259b0b0550856f5868aaaa1db477a72d65896f5846451de,python,21,12,9,23
NB_5d8456a2ab89fe668d257ae23491cfc499dcef6b6ff0d1160f9224c694c39cf8,python,19,17,2,2
NB_4c0c23e6da9edaf19c587c6a0ccf38d81b7ba130e81e7f50d0fa259611502854,python,22,9,13,207
NB_717bedacd1ae469d3ec74a9ec2da80077d4019fa7e96c14100fd07b569c10ff4,python,39,30,9,9
NB_704335dfc1b5ada2423210d6b88b4404d36ecae7b91c254ef9061ebf2a9fa384,python,39,23,16,41
NB_860fc363c2b64ab4dd2ccbd10ca5bed2eecd379592930b30d6b72518ad0fb7a5,others,0,0,0,0
NB_4eab76063933f521264365003a680e4185f4ceba66cc9966676cb6476e2c76ab,python,25,9,16,193
NB_2e4ae952f38c34fd25389ca986347ff5ab84f2a1253779be73a24136f54d22ce,python,25,14,11,37
NB_e96e4c2dbfd660c60838c19c6cea7e8b8cbc757eece0cc85f492722c34085f8b,others,35,23,12,31
NB_b7201f169173a91dc6641641561db6cf3fbf55948f172351b312c7abd79f180a,python,24,13,11,73
NB_68d94df92974a13062d523a3ae8a5b3ab4273bf9e598af3ece7a1b2c9b6704f3,python,1,0,1,38
NB_e1bc6a9d527d1cf4d24cce192b8bd79d767aeb312fcd21be9fd9d11bf368c3bb,python,11,5,6,26
NB_991414568133ca8ab700a8b43536e5927ae0c6750cb245fa2fa4c1240cb2fc72,python,64,44,20,20
NB_27a5e8b50cec57ab7e0bcb42c05f13ea5145363962d6be2a3c1299750a1e1a8c,python,35,35,0,0
NB_5df300ede2721c6367cacc7d6d31f8b702ff22d82de0d35267c67ab5be35039a,python,62,28,34,90
NB_133adea64932bdc5418c1d4a031e73850a1bc25c5177efdde4bf58a5f73e34dd,python,12,5,7,11
NB_1bd2b6f74b34cb3f7319dd620e4132f1d61d43983312c4e96e7172b73f4e93c8,python,16,16,0,0
NB_ca5118a88f8f2637da5daab07c0d0d012ba791b537e50dfa120121890a78d913,python,70,25,45,242
NB_e321f6b8fe8b95a44041b3048a067dc976b325145a09b7b5aa6bb316d8b94378,python,10,4,6,84
NB_2991d7a8463294627e10aed4ffd4f1e46106fc61abd252bdb766a25547d484f4,python,16,14,2,11
NB_205b639d3385f9bfe72d4fc975f4fb2e6afe819166ff0839f6096feed85e27cd,python,44,25,19,19
NB_7403e20472933aea8bbef15ad167ff40698003f6d37414d3f45f0343a243a09d,python,13,12,1,1
NB_ab0d114909c3af0d1f44a1ddb921653ac74c55975d28a0f846baaa954c122042,python,6,6,0,0
NB_5c7e6331664792c7435b1d900976066a8563fb1832eb17294e713c37626f19be,python,19,1,18,57
NB_44b445bc68ad9e9c11017a3a37690bd19d4efc56471e99fb77ceda47d99c9444,python,17,8,9,12
NB_82f230d6873a742e5e8ee71ccceadcf44844424180cad46642a8ab13b0a473f2,python,36,10,26,148
NB_a36d1a5557669245d4e9ec186d996ccc55567539c787ac0a623f7be8fe01a024,python,11,4,7,61
NB_5d5e32dc0fa0ade5823c29564fe9de8340128c7c59684fff4270569175f618fe,python,8,8,0,0
NB_ebcb38e3e878123bb9191aabb0aa8d2e1dbbb80d66b5bf38cb303fc0cf98de7b,python,34,18,16,140
NB_2a6dce40729a62160e76b1c605459731d83542bbea89fbae7436df5f10d726ed,python,38,33,5,5
NB_13df597aa9af63f8ef46f284106e42dd192dddf33f6014f75a7922ec39402312,python,38,33,5,5
NB_3d3851a6285c150a49766a2241f0bdca40ad52cd7dd3befc64253d41e5157eea,python,38,16,22,242
NB_80dee17a612b0614ce6d40a4068c105d8dc1605d47a69956d809b24f31102180,python,3,2,1,1
NB_8afe3bb40d176b75b469aae158bb7b4ab2bd7c6570ac758d4ac1e9a15bcbefa8,python,228,192,36,36
NB_d6adc44eb4bf3b680bbb20f4773c853cf2abc07853339657caac16ffe903fd52,python,45,28,17,107
NB_ffcce9b08505a5b3ef8dd88181d56de2a984be88d008743343a1c23fb61e0322,python,63,54,9,20
NB_af004c009589685b7c9a078aff3bd78f6647f14ea3a7140eb784aebbd1e40616,others,0,0,0,0
NB_a02cc14a10216c3a62dfc71d3804a73a3d73263e03a61d2ff71afa731d94ef7f,python,47,35,12,30
NB_c7ef8e2059334c752afc0d4d7536a4e0eff7f98fb05a4f666567e31c0fe5820a,python,17,8,9,15
NB_49cfc2915de23f6f374ae84460b20d1e10d0e31094ebea7990e48a6b67ddffd6,python,23,23,0,0
NB_8ef1689f7018988e46f2df81c779f82bc732c2dcb9e91721cf74c65c0eec0853,others,136,84,52,122
NB_3a0a9c5d93fff2048ae3d4e7661caa2ce99b2aa02c57c56965ea339badaa8fb4,others,64,44,20,23
NB_e9652443437412c54a1f1251dfef6c48b92e4e0a99d33752d9b7d442049b666a,python,69,17,52,1120
NB_3d2b927753aacc930365a7e6e04e3a4d1b0a62b37da6bdf900c56b6b7d65b85d,python,12,12,0,0
NB_02d571b61a14de8180b8280c4988c265802c97c3ce2b7968ab1384f0275c19a3,others,9,8,1,26
NB_00ff91c9c28a2af4fafb851fc70d8cdab537285db46f995e322b9fd977452635,python,5,5,0,0
NB_44a8cb9a640d09f02a2d9eaecdd25a68fbaab80dffdd152c8c29f81eef3646d5,python,13,13,0,0
NB_7f7fd2791f47873ef1b69ff5961cd92af24f2931e13f68543a8a2ab504e1fa13,python,78,29,49,279
NB_2b7e59d78df18f404f55602f307abc28c9b58fd98e11fd04ebe9104a6c1a185a,python,16,7,9,148
NB_383417f734ef361d504282e4adc6684a28a55234811ffd4e669e4becac541966,others,14,12,2,8
NB_76cc101056f40fe62d2301648571fe7cc66b117adeaff325c20d5351789a735d,python,11,6,5,13
NB_1aaf9ba621649d6d4e9875b82176084be17852f96dda56b465cef5e0afeda6cb,python,44,22,22,49
NB_a9b0640b738d9adec548fb02d099b9c00af7d91804460120a760f84138f16c77,python,58,31,27,52
NB_fedbe49269b550ceda4588b05bf14b17e83884be94b3c641f733764d97ef7374,python,16,16,0,0
NB_fad93b7a29bfb2835825bc83e7009dd01d4f2c5d221e4b790f0d6788fe8cf49c,python,3,3,0,0
NB_45c20f1dc233503bdd6883ef65307aecbb70d2718bfb56d09df2d5ad187aae3e,others,22,20,2,5
NB_233ace0e3566687d94d3d073f0ed057c8cfee975c8ce9b603c487cdaf77de21c,python,17,12,5,13
NB_bdccff57e97aef1497d2888bd46ddf4d40c3413753cb7bdd6a1b5ae3111ac354,python,16,10,6,18
NB_1071e03bf7576778cfdcb1db61dc935e6450b9e6476d314f248e9175cca15cc8,python,16,11,5,5
NB_50cdc69f430d3e82cc6b3bc85f14bd22415dbd38378d9e6e0cba6238c72a2138,python,37,24,13,19
NB_50b3f276b17df6c421d1b6601c977a9548b6dbf933043e1c2b18513c9e73d1b9,others,69,37,32,36
NB_f656d41875bc2d0c83ef64a5a4ce62398b873c2376286da3ba39a802419b028a,python,1,1,0,0
NB_634710de941cdcd37b0e73ddf0d9667f1e21f57edb8f9506b88459ba29eeac92,python,18,18,0,0
NB_c158623f5ed63445fe7a21fe02dd65c3277c95d64bcbb4390826b8ad29f79691,python,54,50,4,47
NB_86241a08c0c57a04e17c4933acd13e3c2eb38aa147042e2a55f813741b7575ed,python,21,20,1,1
NB_28e46e5b4a3068a8ee17004ff8683753da81f3ce38813dca0eead1758eb7b7ee,python,2,1,1,175
NB_2ee025e495086d83b244ab99d91ea725e364c718711a3f58dd876b2003fba21b,python,11,11,0,0
NB_4d631b7cfc6cdfe5a3943cdc7dc9a19da3ebd33368359424967dbc7a447f5e9e,others,78,45,33,37
NB_3ee44de1affddd318af06b46e993f1680afb0c15015c3928901fc637443175d9,python,23,23,0,0
NB_cc8df984143b8893415806ff0c3036af669d320761806ae191239f78cd6eab8b,python,1,1,0,0
NB_1aa0b4dbd3ac503cf656ee73adcb56d8c3e16748677a2b4a937f61c1095d10f2,python,2,2,0,0
NB_5e84c7692d26199f09eb64d89ab75831aca35db64e54bda6091479e569032282,python,39,37,2,2
NB_992ce2faef127b179931033882efd3b4822e71cdd4c2497fba949cd0ce9c1d8f,python,15,15,0,0
NB_62016cc081ce906d6d9dd7d66cc9f963be0c781e8a60c77767053c18a7237c79,python,7,4,3,23
NB_796f86c4edc3620b28039da01a45401613f00ac85547a5d43d68f8550c5f26e5,python,27,23,4,4
NB_b3ad06ae98fa4c1142db65e33162150778fd3e3e4ce0409155138dcea410deb6,python,131,102,29,29
NB_21988860d683c8b271ee8063b12b6ad17e705d57c059bf129a11758e95304ed0,python,8,5,3,19
NB_37206968d6a0fb9d6d8358c6cf4b80919f1056e6adf1e0c7cc7c44606fd83df7,python,32,23,9,9
NB_1ef4a40e8dc1d3b88ece1f16882793fe60d0105fc11ba9059b78d668ab1270e1,python,2,2,0,0
NB_0924b2ec1e3b9bc37cb65e10074b8b7a8dca2167b158bd292624cb5054a10335,python,149,72,77,149
NB_6420e71aba9df2e6bd69b93a771000dc67e3ffbab1bebf718d678a16a274ed9b,python,37,19,18,191
NB_e98929f00ad88d10386fb0243d208368ce6936100043ec98c9f6e6716802402c,python,204,154,50,69
NB_d1748d752fad34ea8959c0f8d2e6e61e7d76a6df34a863a2a42772a0efa2266c,python,50,36,14,219
NB_846b1972c0d4a2fe91859cad026d02e59ce6daebf5f5ef5530d10e9bd956a0d7,python,72,46,26,64
NB_bb49a20243541d4ee9711f38a2ea72bdbfa5b2f9bc2abaeb073963c79917203b,python,34,23,11,14
NB_f70ccd091b3a68574b06531d811c6c54750697400e9b164431e1bf596e0d0ec9,others,22,14,8,12
NB_853de8ef178fd876538854e7ec791af80c279a69577907f01403d8a07f62e7f2,python,4,4,0,0
NB_f96d81464e6ab9d52ae18eb8296008cf0e51aedf44b776c86e6771218252532b,python,65,53,12,12
NB_2cfbf077e3670bc44eb0fee1486e7209f52b1f9edb6ad50631c9070b748d6abc,python,13,6,7,74
NB_a93797d078320b120aeefed5571e1dee7ba25151cb9a7c7eb1f4d8d260bb7f92,python,54,22,32,62
NB_7fae899565abc82ff842c27ece9105d4d884190ecff84f5f05513dcfd8ee3b2c,others,0,0,0,0
NB_129ccab6ca4a22e7104743c4811d9a6dca70fd7660b7debc225ca5c050ffa109,python,72,32,40,111
NB_b03fba20cb069cacbc7ba9bbbf2b269b662c13f6e3f8727dbe7d1c7a1374e653,python,167,165,2,2
NB_cde87352e1fb28cfda8c7f5598f53686dd8c72793a60061f8a84e40a30b2e307,python,9,9,0,0
NB_06773f5c4692ff7bfd876e0b963cb202903719335c774d626ad395f54feef00e,python,11,0,11,37
NB_b15278bd6e42135e811937fc2a915737853a0e5841bc5f5ff00c7b4f15b7cab3,python,28,14,14,249
NB_943ec2756223a58f589ea2eeb8f36c2b84466fd8326cb01d0d48af4a6c63822f,python,17,11,6,32
NB_7b2c135b8c220e7b7fc250543dda3f864d3044353b0bde25f4554f6e8274f32c,python,2,2,0,0
NB_30472f2b157125b5d3aa08271bd4650a385fce54525dc128b4ec83149395ef6b,python,10,10,0,0
NB_61d2b71197d4399181fd5df95fe568db5b88b046fc8b759c046978aae9522100,others,94,55,39,44
NB_985198e119fd62a4c19b18c3cd33bc5b03678b2a636b7c06f6094dbfd8e0136d,python,42,34,8,10
NB_4be9f5df5bd0f63c3b8b636e788055a1164a2e4f9b2d58da17a6be9712e1a356,python,24,15,9,43
NB_5a8e8401b98fc0776d0d24ba1bdee585c1589c1c0c6f712af0dafd8b925accdd,python,9,9,0,0
NB_79da169f6ed10727194223af9cf02e158a4058c39cd8626efdeaab70d6834ec2,python,7,3,4,6
NB_8e140acb5f2f3a6fdb1ffc23f846b3cd05729bb8d0afa9dc02528aa278801f40,others,0,0,0,0
NB_14faa2e94ab8a81b5fa2161dcbcb026a9c1180696727e9731596a2587d1e200a,python,13,10,3,15
NB_7560bc963f57d6df336e1e9df37505293c8d027bc85914aee8b1d9c9e2a0c8e0,python,6,1,5,163
NB_3814f351676eb8deafa448b7a659d23468f8a78ac6d04b6951979800af541986,python,22,11,11,19
NB_967c62731e32c3d1a557561bd647ab5fdc141691bb3ce4382c8bef7cccefeb9b,python,70,40,30,274
NB_9c688b903a6e94bcd0e73d75121527c3065521159a95b61a070518e1e3c6d2d6,others,65,55,10,10
NB_c04566cecba022a0fd519ba66d88d94e0751d33b6e44d4a56fc823cc8346a55d,python,47,33,14,42
NB_587498cb1303221387b30e37e5a78b129fcf2565f957138b21a72926c7b5bed6,others,10,9,1,1
NB_ea2f964c90a6b90ba8bd0546a7bacf8274d6834280618b64ed74f1be9f589411,python,14,14,0,0
NB_a93a74ad0aac04eb7d8fe4c4ddf3e8b38b6ac2ecd7b12ce08c04e5f18f3bb7a6,others,0,0,0,0
NB_db8f6df9739a327895f501c5ba50fa4a6d4ef71d5efe97825a694a3306634302,python,70,59,11,11
NB_ab1e54ca7f7ec51df6c18eaa3c409fce5166a6b00e5969ddd1d45b5dfa0d3ca1,python,11,11,0,0
NB_12a3c857d2ae2b8aa9b4d83aeb0bc47887a0850f2eff6aa23cb9259497523e81,python,1,0,1,81
NB_436d50eb2271b84d75cada0991bf5d053088e2599746af4043bcafa2fea2c797,python,21,18,3,3
NB_27f5f1f39da6c57a67b4edc847dcfdadd26de0cf98dd87940f2bdafa07d7cac9,python,19,10,9,29
NB_8dbb81606f5da877d3435a210d1eb4a346fe17a43248dcd4f4e6c7f8b0e9e259,python,12,4,8,134
NB_8fe7e674a7ec36d0de8419c3d2f948a711981f8a7c602be6284ee0e36a01b894,python,28,15,13,25
NB_84b48d8c483b8c29461cf793adc264c3553c00b211ac32c3da2b8572fd8bdd04,python,18,12,6,6
NB_5de9376c9bd5cca120562c67362d7fc3dc2a37509ffa44515a7891394d91b155,python,34,32,2,2
NB_e8e3fe887c9e312004e9334449fa99129655cb02156042973ae106ef70c4c55c,python,33,33,0,0
NB_3925813cdb8a0cf82a12f11284f9b096b6affa4210abd367adee2a77f5bcda83,python,35,30,5,5
NB_46ec08fe1823bd6c73f7903ca95a82c31605bafab93209540e33ef0ba503c825,python,36,14,22,61
NB_2ec136a5031dab4870ab0b4d485d90b4dfdf50bbdb6da819d03be247279fdc7c,python,34,26,8,8
NB_c063e428d4a10078148ef47737568883892d64c6e0f63b42de1c31b4d28c9193,python,24,20,4,4
NB_7d21edccd4dd2ab2c18a084ba773dc3d5eb8fa211163b059968714ce8397a5de,python,14,11,3,10
NB_077a0fd9e8ae1b073b5f58ad69b970175895b05385ad12d8d2b9ef14f23db2a8,python,89,61,28,71
NB_b27dfba4a13a5ff05de15ae7c2a996d69d1e007b34c3a37c5a4aacaa2771bf16,python,15,9,6,42
NB_0491b907f71a0f6cb74c6fe6a988c9ebd1fd5ceea557fa18da6dbd88943424ee,python,13,10,3,3
NB_604f3dc80082db8292cafdb2e00d984162d3b86d79786399fc05e8f3c24b2dd7,python,2,2,0,0
NB_0cdc7ad90095ea88d7d80fe734517d883e7cea8df841156f9dbae8edea23f704,python,21,16,5,5
NB_8b07d4d4624ca5246c2974fcf842140104369bd1cb9f9578b31c424865cadf0f,python,8,8,0,0
NB_48a22366300871d994198b7ca971df384357622535d33d575e61b49eb2d9136d,python,38,26,12,38
NB_7e0aee0045802063b327f61ebefd4c4a059e03afd2bf523c05b3f5330b75a6bb,python,35,15,20,213
NB_0bec181063332618f01df0eb71ef4dc7ba8603f473b3191ee55c8df400a1c534,others,86,76,10,13
NB_ac6fa51b4806ffbccc207acc1d56eb55f97518c9c61357c3359ea233daa02078,python,48,39,9,9
NB_3587712b66405938fe2aa61696d9661bf514c95c9fdf04596f293b509f08e279,python,12,12,0,0
NB_43eb9912b56506661ad1f11df87bc143c69c9dbfbbb547bf00e194b8842d3a8b,python,158,122,36,56
NB_771d2da070d704569fc36eb175b5ce0f8ac1675331aafbb9fc0e42ad70cc4209,python,6,3,3,22
NB_acff2649e9ec6124d0ebe4001c594139e5d823a807d6b921a4ffd2c9767a8d6e,python,46,30,16,101
NB_0b071a8b8de9f5c867aa2dfdba5e4a5a7754ada1198f1f008b18fef719f13fea,python,35,27,8,11
NB_f6be7ad3bae79bcfb7bb0996a3472a4bd3e9118cf66057155918d76576cd1d7f,python,18,7,11,39
NB_bef342b154b962da5fc691ab468bb795b424eaa8f27ebb004fa563b502a58c79,python,34,30,4,4
NB_f1ad49ccbecb83ba7dfd3d5eda8c0331298c5c417e43d84ad89fa8302eb3d086,python,14,14,0,0
NB_4767ab41f2d9eb7f0e75e1a11bad89345a0e5d0267891eb3fe1e2bec9e0084c1,python,30,16,14,14
NB_1d6e350a9f65763d95396521ddb7d09acbd927e5979b87cfd85f869e5bb8f650,python,15,7,8,8
NB_595b2aa440d00c9769832b93f8792d12d5ba01f9db26b8af02d44be921a7cd30,python,21,10,11,134
NB_4fe16baf64c03665e4b1537af4098221d08cde017222720d4e5fc2f69f78ca86,python,32,26,6,6
NB_c5d8ddcd8c1fc2752e3c55f36c6ffd3275d5c17d848ab8ea861ac6c7758f51f8,others,25,24,1,1
NB_bec0b850b91f541ff52dd3b36f4ae04086f495066a0c2bebd59dd2bb01fbb37e,python,133,61,72,117
NB_469a0cc26dc2d9c58158c211eeb00c5184b9c0ee5ecc9040cbb208e4ec517b76,python,5,5,0,0
NB_13f6b11d0549dafb7ee06707576b08b41f9558a5fa9316df9518ef4811f8621e,python,20,20,0,0
NB_ccf3d244baba02f37a74698f18c444be6cd57494937858c242002e4768b2a895,python,53,17,36,474
NB_325daa7fd6cfd1461099e85aa76c01a4a1b955ed4d1fcfb0f1f7b08e1e6189ef,python,16,15,1,1
NB_fd70edee0414e5f2020f8ec50a5d493870e884a85a45764ade83e7fa2beb8898,python,31,28,3,3
NB_af7a8df54c70f2ecb602e27edbda5335b15a5b8587b756dc8918222f050a66d7,python,45,44,1,1
NB_5de94282ba160f24b82146f127d3f7cd1950aa601aa59991b99cae98cd0c8455,python,77,44,33,128
NB_309435bd92ce5c7024791f6aa8e20cc3acfd61aa413afe96f30e7b9976dfc749,python,5,5,0,0
NB_d8171a8bd78011d63f589c1e3243922e58c793406eeab0f165f84e9692af9461,python,6,6,0,0
NB_37c451d5af029ed584f2ef36f444207c27e480d7e0b3bd94e241a89425ae9372,python,21,15,6,15
NB_3261f6c852de4d0704e6ed9459a72faf2a5b41395b7c26bcc58e1883c6c45baa,python,32,26,6,8
NB_c59b2e190420388b84ccef73de16aef5bef15f091eeb8af3a14b082c73d27713,python,39,17,22,70
NB_e4e430bcf5b8ed37561ea4c48588f0299b3fe7fda8bc4dde86e699ea16b478ea,python,35,35,0,0
NB_9f7402a1157fe4c74c353af7e05f11e5e4b917a97a57297b647bf6c22a83b927,python,4,2,2,2
NB_e1849764d3d8c858d9f61cc6efad4926ff4c9737f0f19f76d228f660dc44161e,python,13,6,7,12
NB_5ef1a0eef141a3b8981b67a5097a685464053e9ce608c9062d86fa2ae9010c04,python,19,11,8,15
NB_e8ea9ea065580e962cd28720300bc82f7d7f34d7bc01ddde004147bf540d1a6b,python,8,6,2,15
NB_f12e1f6d3f1e3ea68a1e6c5794373a9559cf16f6f0c7296cab71d34f98a16c6f,python,34,27,7,43
NB_4c8e49bd7428cff46f27a9239be1cf76dcb29056fa42fb66e0f4ee36389fdfe4,python,20,10,10,81
NB_e12fa9d4f8f4c97afe02b79511c14c8b041497ffe9ed2e1f0f2e312b512883d8,python,14,14,0,0
NB_1c4bc708e35281017e0667a43e4283824c8f2a991daf3ad348632555d9557964,python,33,16,17,106
NB_8a62e5689fbe74bc9d829e80431ace419f60c1307fc490a5008d144b12d816e9,python,2,2,0,0
NB_1759d3330b2b1309d3bcd89262581fb73cc76ec3830730ed338073dd0553528c,others,7,7,0,0
NB_0e7410683574cfb4b604e93ff61acc3ae1a75b6e6d237449917c6f63fcccfad5,python,39,30,9,17
NB_8b40fe1412f0de7ee1ab813741e9f46c6d0641f2bf1c2c964e650c88e511976f,python,3,3,0,0
NB_2e5eaeac0a1f94e035dcece0e0e54f872f1eb4b521ad067842fc5631129c76cc,python,88,31,57,385
NB_fddbfb0b680a4b152a79364942eec16863fa7f424177b64a4c3f48f380d843ff,others,21,21,0,0
NB_df08ad9bc014362aadd2df0019d62918dd2765e86e62d7718bf94f55da3c9e48,python,45,22,23,36
NB_11aed3623b475aa2a56a629cfd8e514bb7cf44a2f5081365d86e27a41e7a73be,others,97,43,54,239
NB_84555400233cfb474d139d6282e012cb97b1ebf252fa7eae911c9c7a7c4bded7,python,11,7,4,22
NB_02d7071cccc4ad90145979fcf7e6d10e3a451d1b94318b2b9d27449835f39b80,python,18,18,0,0
NB_08327c53d041b84c4ecb8cec971f2d585d88d0d5538c438c4025e65a7e816830,python,11,11,0,0
NB_a10902cbf2c2fba3d87e05149eb6af3a7737aa369b830be695d56ab0e284d8b5,python,1,1,0,0
NB_958973e3f6b5ef7c5ddad141b4d08fafb1d8b194e1d41253638ba57085f9598c,python,18,11,7,99
NB_bb20296f58c1e5409de57d4fbd4edee129976c753880e96d590aac60a73cc915,python,18,12,6,17
NB_eb0c79a3ee5ff87a0717df0060777fb624649086229882c325334cad82a3cef2,python,8,8,0,0
NB_64a1484f279308235289a007376d679d261eff3945677edbec44da3d9654b9e9,python,23,10,13,13
NB_d5c51e200ab096430ad2a2a709ffe5ee876fbe8780a10c0f145164fd13e88179,others,45,41,4,4
NB_f6952596e635f65067d0f9a9a0ed771bc4a817da433b368a9bfa919132b9176d,python,15,7,8,13
NB_6c5960c9db4f0ce104c8ca64e26d9ea9c625bd0577d3fc7e33de124ad64e2f7b,python,19,15,4,4
NB_9907c0ffef522a3ddcefbd7ee1cabd3e5b4a90e9781e83c7e3256fb342fad09f,others,78,45,33,37
NB_7979bd4e20bea1d4b32e4af58e4f18f06ed76cfe53c6728952fb0713a9a5860c,python,15,14,1,8
NB_0adc283710081689a69193dc9f0fec25bcfbdfd4d46763a4048c338ca110e273,python,1,1,0,0
NB_60373e78d2c6407bfe9dd03797dc937baea6cd26b3669e30bd1006f278ddcf35,python,19,9,10,52
NB_bb88198667b4fe297fc7fc5303c9ee69f2441bd5e4b7a1167ec252c0a2ed12d7,python,15,9,6,17
NB_82a5cef073a9710f72ad7395e6dd4c80cd8dee4d076a893c498d17cbd02d39b5,python,38,26,12,12
NB_4d254eca0cccb22e5aa0313696b153fb20c242007484114dd246ab30a9d41c19,python,57,41,16,48
NB_694b3ef093f1c1ff9efce81b828c7ee548129d65defceecedcaf4dc76cf68378,python,2,2,0,0
NB_ca012ab2a025f09685d248c079ffbf5fad4b1fe5104965e8ce1bc709b5904403,python,5,5,0,0
NB_274dad9e1552dc9ab4ecb5c6450efb46ef5f30f805d2b2dffe5063f34bcfd9a0,python,43,26,17,28
NB_3952e0e7987c56d855c4c29ebd4171e4655abf186d5783980243a9ccc90d2eb0,python,5,5,0,0
NB_c48220f356b7c67f7a185176f03c749ead59a5a06793d09487140a153ad52c66,others,11,10,1,1
NB_984ba5808c24097819d3a6e600587b1824826c0c6be5e448b8490a64968c4e06,python,10,10,0,0
NB_0cfe0d4628f10317c44fd80bed9af7457ea705278f4cb0c4255bbbd1977df915,python,27,15,12,93
NB_5c7511a8573b232b7bf825033c1400d30275a0454b33e9d0e0d644d737ae1675,others,94,55,39,44
NB_a9cf9c8d7c37540671638f0d0dc86591678c9a9e161932f46f63e2ee13cb0189,python,50,30,20,90
NB_2bbd7103ee7e367af4e9322dc22ffc44e3b09abd3f135565cf38893fd3e11059,others,10,10,0,0
NB_6b9eeecab70351de3a115872d6b34e226ee0ae16a948a2430b59830f271ebbe5,python,59,33,26,37
NB_1e93cc057818e35f0dcf59ffacb6d518440b264d847c60f8a1be9f60d6a32303,python,29,15,14,24
NB_55e644075bb1483ecfac4a21a9fbef54207dfa87b69daa72d6777a2de3afb4cd,python,27,13,14,59
NB_94b54ce56e1388bc900128741f209cb6b98af359c93b6dc4114391e4927dcee1,python,2,2,0,0
NB_470cd656a8768c3fca74d9283ba41747e4a9fd3ffb2b7c885f38de4ec08fc058,python,34,34,0,0
NB_8397f85e3eb5becf961f6ff6912ce90f144592f7d0185a09196eac2180d9d2e7,others,11,11,0,0
NB_2527a1c50e2a1ce16f97454285d63f2255dceb486dea8938cc610199712586bc,python,36,36,0,0
NB_b44775fe3094eeaf059078833c07c5cebc2fd2c5cb85e11305aa4a8a188fe9b7,python,6,6,0,0
NB_fe59f08698b4218fc5f23c7efe45bfd53a855f3cd04dddc3c4a07c50b833e19a,python,1,0,1,38
NB_bf92ad32c8c0da1e0e416c6025605e5954fbb4e41b39f174e2043b89968a03a5,python,14,14,0,0
NB_b5719349da5b07eb9f8b629eb9c3ddc9c060b12c5246fafcdc637d6eaeef0cab,python,11,11,0,0
NB_cee84b4365b28b3137f4b350ce59fbb22fdd6f49ec8f9305ac77c721ef1bd545,python,54,14,40,290
NB_13568aeb444b60662239bc1e4e28e404ca49e75136baf4e984d3ec6e8a615d78,python,97,54,43,159
NB_d4b95a6a45003698a530b8cd18a196fd84c11173b7eaa351c01df7d3db5e3e69,python,10,6,4,25
NB_b3f8f6d452fb072de70c446ed15ffa99e90bbf7273744d7c2e971af96d81cd0c,python,11,9,2,2
NB_dc19848af5d3d0bf913b516cacd8cbb817512360ce40809157cf194a10dcb893,python,65,52,13,230
NB_ff4b5f13be8b17ffca95f61f6c3675fa7bfd4790c3124dffdfd0f637d188110a,python,26,21,5,5
NB_87f3e4ec291886b6ef4331c895e097c0bff60b0bacc7d07a58718eb0457f502e,R,34,16,18,62
NB_d8dfd69efba2c1b980c8d3f38ef9bff87c96afb110ab23dd99d41d48ebfc5834,python,25,13,12,39
NB_e56cc15c10d96789cb3628f0efcc33029846fbd79da4e28f7e33044a1773a7f5,others,27,27,0,0
NB_fa098bdc26d8d377b716be9c0a89179ba9609b1473f26db87b021177356a9471,others,41,33,8,19
NB_895728ab242728a7fd06959716ccee52bbb16d78f122691edce0a22792dba189,python,17,13,4,4
NB_a609bd26602043ef4b108df5dadaf890db2bcfdf8397bdc9580a5fc37e52326d,python,26,13,13,203
NB_50938f323765e86edabccd0040b6efc2c6fefaffc242c8ec7455c8ed19a0908e,python,96,70,26,240
NB_a933b7f526fea381c10e5d8ecee11927846509918cacd2c892cddf55155120f2,python,11,11,0,0
NB_d64aa2adee0fa55257317aae643ac750c622627faf4093d0c34d3601c8885281,others,75,42,33,39
NB_ca954ec61009552005f8812f0d7d90ee259d95cee03930636dbe3b63635f0bda,others,55,44,11,22
NB_c168167377fe8ba26bed42c9f62262b44134dd92f5476fbb0bd59e4483048d89,python,148,127,21,21
NB_2d208e2bd12f852eaadacb31b78ef530ac3e52dae1daf364f4d9af930d15e232,python,47,24,23,23
NB_4bb4d92a282a23350f1c8464fee2ab388db16c1a0a72c194df827e90709efd1a,python,52,46,6,6
NB_6b7586cc0578e57573fcd557bd949380df55f09a86861d07748d7ffcce97858b,python,13,6,7,11
NB_e3825856ded21b5509338deb6f795ce47509be170a7ce0c0926bf033bccb39b3,others,117,108,9,9
NB_ea92a4fe643fc9b3baaea9f2f6e8facb1ff2115d6abb9d0e64144168af6786bb,python,39,12,27,226
NB_4beecfcfa15407b95abd79a74edecaa660a97b0985139c90415fe57b6e094e21,python,29,28,1,1
NB_3e0aa8fadf9b3df75e21c3a079536e4031e2847f29b74ead1c35372ec3b3781b,python,50,24,26,89
NB_2e56b3d3e99a8c8df67920fa84bcd2decf16d09a3d790e1fb317d419cdf9cc12,python,20,15,5,13
NB_df78c2df76d3e06182b89378cdfd7feb18670983b34adf98cfc0985b6414609f,python,32,18,14,148
NB_d34a6622fbf730aa4de1963db5ae8442d84998797c6015f8e2e459511fa5eabf,python,19,17,2,2
NB_fc50a92b6a457efa1d28220c535d68caf44fc0b5509a982d3d931fa9f6ed6940,python,12,9,3,3
NB_36c263f5da4e5d3b8d1d7133d13fd2ce1c09e804cc46a85210de094d0ff419a0,python,57,17,40,281
NB_0e580767b2cfaf3681ac25f91f297a408e644072989d2a0822dc9ad3a3fa0b49,python,23,17,6,14
NB_6c451eca974dd468a3ac002ab49480b8f3ae4e6a245f6011a96ad98dd62cf5e8,python,19,9,10,52
NB_f311603dffeed037831a82a65457cccc65f455b35bae3ac31d365e33f971ffff,python,39,37,2,2
NB_e6b5ab37268df325f054348961991132e4712e880be34a8c687b116cb14689c1,python,12,12,0,0
NB_59b66612a1ff5c409f04fcc254e9f24b11714d05ba0ff75b6fc8f2491641b17f,python,32,32,0,0
NB_e30b3f838404b7ea414b5b235981638ac365f1c51a9dc156f5fa5e21b44e6f2a,python,77,60,17,43
NB_56d8585fefe509fa45645613324fd43419c9e49bad56fdfaf1623caffc124939,python,15,7,8,29
NB_4b4a3d62584ab01a8b0ee69836ed2bba526737e9c1c12663e7bb2b549a190177,others,22,9,13,47
NB_46025daf2b6b5d6285781cf651d521ac720766ad4b0558025db4ba2fb27215f1,python,25,14,11,93
NB_078c105c2b3026f8e75e4dc54d3f735ce5c5d6e3fcf57ea1c54a7000546ec6cd,others,28,27,1,1
NB_4c5c46a89df5a9b4bb66745029047f905b603d7cafc67b00c4cf96e3e98896a0,others,39,36,3,3
NB_833548452c9b7f117017da35baf1175f8022b14f84ab0724000816c97417be63,others,39,39,0,0
NB_076efce9b6980ab2357d73b89e5680cb16f5dc9e9da3f68a62fc99cfe1c2493e,python,64,28,36,124
NB_d16618365d733c02f84042117302c12581636da864021d13808ce18d9ae4aad0,python,8,8,0,0
NB_aca21544d278d3be11a384afa03677656f207de53f79ead696e5c2f87460d891,python,51,43,8,40
NB_f2958bbda108d4ef8cf1647a3d20e7139ee3221cbab7063d750efa5fee4be7ec,python,97,74,23,50
NB_cfe4843d258f94d2a17aa65554cba9884e54ff55174adf0712e63022ea596ea2,python,10,10,0,0
NB_b70606a2144537d641b450879dc8a722acb391b48aef0cf89c38a1ffc6fe91b5,python,13,9,4,8
NB_544d68a355b48eb21e90702393d7fc4c2964d68611e987febba21520b9d7b5bd,python,66,63,3,4
NB_e25ab35950414004a1755e5c6b33bca1fd4ddf78c836e5733507f040f4ab476c,python,92,47,45,269
NB_bfc7e1b657660bb6cc03160216509663f9785f5264b698884d7176073ab6938c,python,8,8,0,0
NB_81bec0f617184a4ac968ea96e5d7ef0927334bbfb2890814da4cbfbdbd936c23,others,27,26,1,1
NB_238cfb4a2b542a4afb5405b94161b907cb04a8841bd512e6fb28dfca2e16d9ba,python,10,10,0,0
NB_943ecc31a4706d440f094fc02a1300d1124129bf67855ce5a80a14cad5f43de1,python,6,6,0,0
NB_ab16fb8ec58fa32feb5d06b25a450c94ba300954971e3e63fb4c5d7c7685d961,python,15,14,1,1
NB_a31531a8c3fadde9a98a84ad626130788275d22ec8b8d5b2b5c36926ccdcd455,python,13,6,7,167
NB_046bbc8261a2133ed327b117de3c3f208d6e6dc84adc049581ba26379638b7ba,python,3,3,0,0
NB_df996a2b45f941d025d06d13f4ec73c1feed3275a8f5b9f12c78b7b98137a09a,python,11,11,0,0
NB_6c02beb0c4907a4db50ade2b8db9528823858b04f94c64336b903b90379be201,python,69,54,15,22
NB_769dc53a9a68d68e4adc8e128db31d370e9872d209a4c6f062011bdaf1604a48,python,31,27,4,3
NB_df754aa3648d4007904302b3c393e37caa9639b59e33c423da51e7c7dd6356f7,python,14,14,0,0
NB_b789a91f951bacceb4b281225c85ca6535b9bf1bf7e80ea81892adff874bccf5,python,8,4,4,4
NB_9d300d8057560730ebfdf5b2ee1fa439282d90cab5a7faea4608ca766000d607,python,58,47,11,12
NB_dbba0dc8a871d96bac7b7bf3e8bfd1a2e2d2c47dbb0272582526a45c992b1aef,python,13,5,8,204
NB_e27a80d765a3494281ed4a2a457640babeea6cdd68a934a9de9f6f6ca94c1336,python,8,8,0,0
NB_b5b620a7d1d4e75456a2bac01263e2cd14044560f668a0a330ec2d6ecf55f38e,python,27,19,8,15
NB_c886ef8a34378d6127e687e1defe89f70d45fe4f2d0b9af69e0daaf52360f176,others,4,3,1,3
NB_ed494cfb400f98d7b7e1a9705377b3aae03b2cca34f4e39b7432a5b511e4a43f,python,1,1,0,0
NB_136c92dbf641242fcf7bb91186fcc2189ac29c07c32818bcf0715b8f3b1e094a,python,31,19,12,80
NB_037c4b0c6e350431ebbb05d933b1db5f0e431b596d9e5daca56bcd989355f13a,python,6,6,0,0
NB_82276311faa29655b03a05fbdb6791b29a7783bcfedc89be8de8371b78876489,python,24,12,12,191
NB_945ffeede76ce8f324a6a1c9e313363f24d17ab8d5f7faa34d0a91ccc2458d96,python,10,4,6,10
NB_b38c13ead3e269f9440425fe3482d2055bf872a0c94d53217b21d06830e36de5,python,18,11,7,17
NB_3c1a01f2cd0320861d579e3eaef654e7e3913d322b24180c7fbaab52e30bd8e3,python,46,34,12,12
NB_8ec831b0db59140ab470bf6b32b63426006591cd8c8c75f7c2533c4c951d8307,python,18,9,9,21
NB_399c74781704c77b294619abb71b8bf351f738cca04bbdbf091797659a26cc4a,python,6,5,1,1
NB_14ffab8c2704f7d79afc62d8bfa7bf65934398db5ce09589993164c4d2c56a91,python,19,10,9,85
NB_69018a2653fccd2f1392aba28c7dba05fc6cc7681cff9d2a98d8f58bb150c8f2,python,34,28,6,32
NB_b4cc3c6fc25fe8420d3ee5511a6be82f207f522c1caecbf5f187b0933b19985e,others,12,12,0,0
NB_9dbffe1cb184569b92b3b1130d136fe146e3be6cd848d526cadc34817ddbecb2,python,15,10,5,38
NB_9cad174edb3d0e7683838ccf84a66169d766c829549aca2f99f687b2425dffcf,python,32,29,3,157
NB_8adc4a840ca70ef212c17fd4a33ec4c0472c3d9566739a960f7de501c657f744,python,30,23,7,10
NB_99bf97ad550be89a6bb6935075861148beaade3641d2dbbeed5086e1d6bb3d7f,python,44,34,10,20
NB_20cf51fbf32054e419d49e5a824addcccc5104bac40afb7ff378cc83c7793557,python,40,40,0,0
NB_5fcfd3456151a308f6b898f4bff0007188c2e14589fc2f036b30037ce7522c20,python,16,16,0,0
NB_8efec71a3b2a7faf73961457b42155caaf02f167673427f7a01e2952cc0da426,python,23,12,11,13
NB_b9b78d237d783fe32ec68f10fd5cd39e27acaeedc0a086b6e2827a09fb00d3ec,others,14,14,0,0
NB_7c036685ee86c3270767a17adf2ff3708e39d9945f2860fcac467d35a5a54d38,python,66,39,27,209
NB_f74db4b0d14c872ed5ccf43bfbffb7bd78808cb29ddb20e608444c418a4e5b53,python,45,24,21,98
NB_e09b9b75e4d9cbd33565c7fd25e251645d762cf8018b4c9be8a1b133da7a89d7,python,12,12,0,0
NB_ac99dc1123bb472153c3d37766c4834d607b72ce1cd38fa3dbaabb9c60d995e8,python,4,4,0,0
NB_84cbfd61e29b5c949321c330743f86c88d680785c6b70e35bfacd365945295d0,python,22,21,1,1
NB_e3f110db81b73381560708f4189be5b78dbf0375ed8bb8260ebcfc2a55bf6a8a,python,46,46,0,0
NB_46e551097ea4d81021aa4735b16e4c471ff30f65c56b045e8488b122440595a3,python,26,10,16,52
NB_18aaef72357392ea6835b66c3d8d3f67ef4f798d7002716470531d5264833b46,python,12,12,0,0
NB_3c57c05ce7c88c58747159782223526416d96db5201c8fcd2aba8a6fc959cd98,python,43,17,26,230
NB_b7f8fb04dac5ebf8b7423343e5b585fa4a23d50c2cd9a684194893d6bc764631,python,8,7,1,1
NB_8952b52ce662d79d551accb8af9e1883f70ea0523f4d12bbb60f1c184213a1f3,python,4,4,0,0
NB_678c3d0a61ae164e92b7bd6bec9e40c8ac6217d386543059a1b175cfffdfa514,python,1,1,0,0
NB_d42ab52e1e84baa36f1513f51af89153c41000adfeb2ce33aee20709842840c1,python,67,41,26,126
NB_c9dbd3c5b125141b2112f5011297113dda43ea7ebe001d5ea02718463c3f9e48,python,45,36,9,49
NB_2de3562a9d2445b93ba349d8acab3a690d0174aecb6054a4f1557345b7da525f,python,8,4,4,22
NB_c79b4c0e05e3497f472ea231203c4cd23bc37bb16d21eb358ceb4bd42fde549f,python,9,9,0,0
NB_c168e910d3d1c743f7b63295860cbb52454a08a9e11b5b4352a944aef444155a,python,79,51,28,28
NB_66b7e62334d5d03eb6000833ff6adfef20804c53300f5b84e5c607a15c461e6f,python,14,6,8,127
NB_a74d17c838ab741d66a4d5dd3c966cba0512fca9cf8dc2f75beb33d3ad78feaf,python,23,11,12,38
NB_26f1074067bf6013b27d72750c83495efd22cdb367d48f78b8a26db9f725e685,python,13,0,13,231
NB_090f9d4337a0369810c4a73182f4252a0005948d24f947474ed3876c163c52e0,others,17,8,9,9
NB_dd8cf81aa7769ee1a88e7adfb47889b61651fb63c64925d6afbe13a368ebae68,python,7,7,0,0
NB_d0636756eacbd2f678ce167eac283ace9b558264179dab0c7f914760a17445ae,R,21,21,0,0
NB_8f2c7d956c33490b4a112c5c2844d551725e5e41897bbc4f2353bde063b6d8b1,python,32,25,7,11
NB_b46cf45089ab0cb8ab302ed6b325611b8a62d9324ded6575319223994b88f3c8,python,18,12,6,17
NB_83fa258e426c475fd419f4f7cbfd9238dc83c0578f55aec97a91ccffc73cafdd,python,14,5,9,150
NB_0109fad261d298dcf5980036d2760a906fbd8c734c70d110bec3b065777f69fb,python,20,10,10,11314
NB_9df1bfcd843578b17398f40a6a9949e206824a7572fd317a3f9cab29b3f359a7,python,4,4,0,0
NB_a22c02ecbfa676e4bd0bf172e90017cb10fb7b9782790f7340e59bf198b785c9,python,20,18,2,53
NB_415524c9e68473263eba4c7d378b4312aab9664d91446d0d059493364a0edf51,python,9,9,0,0
NB_86407ff60c69ac058cb4eb18474bd966dc1e855463c144f93fc90e9534339fe0,python,20,15,5,16
NB_d58eae6d3ae954fc5e1765680db3946c5e6840c8a9d6696e0be8cd56f7a7d8da,python,56,28,28,54
NB_73fb29ce9d9b7b165e77d7b1930889594ac4e05ffb34ae1a38d70148d87e60da,python,6,3,3,7
NB_9b30ab0d651777233e4f66e040136aa2bdbb1149ea3eeab19cc06e8714f5b2ce,python,31,19,12,93
NB_1b0fdc4594a33c841b1e504d68190110c32cad9f146ab6f9f4dc1cdb1f289bec,python,51,51,0,0
NB_9c7bea983b81cd178d1beda25794c20a84ee35a117161b674f3b9a0a6a614f1a,python,37,37,0,0
NB_fdc574bf3cd74893ee76d4cd61ae6e387e706163aa737cb7e8569891f73aff64,others,24,24,0,0
NB_3c7686f32a417e139a56f429509e0917f01b9a5a10f0d44c41a40c923c154d71,others,25,11,14,30
NB_d4d666c963e6fe2bfe005b4cf15825aa9f4d5102fb256716d2f7f2557c77028b,python,18,14,4,8
NB_2c2d26a3a597bd8d59d52c50b3c909ca155c059068635fa1b7b59185ca7f327e,python,104,94,10,35
NB_8568badc2b1bbf29405b4f3b2c8ac4824998213d8e65390e7c8d3e431662c479,python,6,6,0,0
NB_fe43caf87f24db088403d9c4dab849e0196a2442ff81c4e2ec2f2e0f49a937ba,python,58,50,8,8
NB_45af36131f84e35e80f070e75b47da01538580624b1995501d8581bb60e5f1f5,python,3,2,1,132
NB_8537e2fcd683729a2b76f68afff2ffef746edc8ebc1a0794ec09fc8540cc52bf,python,2,2,0,0
NB_afad3c2d079c570d3ba1cb357ed638f3a550f5e0a4f7ffca037f062f2749d5a3,others,47,44,3,11
NB_3d309e19af18c43017b5e37495870f8b2d260ee5554a698927fc6a979e20bba1,python,10,10,0,0
NB_8b56b64464b19b99ccca4ca3abd974c259b7abec9c31f8942ab65addbc771a20,python,5,5,0,0
NB_ed8f07c79666d4218e387b9725a5db4b8cc05d7d5e4809732ef9681827e6da5e,python,9,4,5,26
NB_bf8971d5838527184c9f08dabb2274e9180b65abc3a579a72e342daf77255095,python,10,6,4,9
NB_25d31015d5e7f5dd4b4ff45f436fe3fc7078e5de3d1377ae6bcc540f9761b4dd,python,31,18,13,13
NB_cd80c7d4519ea4ac3f9c1613139ef505036eadf353213e0e550d6287630f2ff3,python,7,7,0,0
NB_9a401f1667c3c00bad80701442a24f08ce06441460ed0b7202bd166fee8b4c2e,python,26,16,10,24
NB_3faaef75cc7d5e5f7d5c57bd46d4f70be1812aa9eceadcfbd0ad9162776b3175,others,21,11,10,10
NB_ed08cc38d0aba1da57c6b08c24059b8eced3d0de8d274322b63249b84f1ce055,python,72,66,6,32
NB_7f7c9a995aae2f18922311a699ab83bc36381acddd94643d86f7a040e5bf6b4a,python,68,36,32,102
NB_83616838ac41886c1852c680b576f35acf559b6ce532f7f245135a8ce0a2c822,python,8,8,0,0
NB_0846166e3c95c5af2c01bb150a6b2f60425ee1847dc05ae8e33421f22b6bbf9b,python,413,351,62,63
NB_662b7bd3cc867a45c66d8c0a281bcc925dcbf53d1b438d1baf035cb65025fee8,python,24,24,0,0
NB_ff65ce0083d8dc2384f3ec2b6f1299753fed2e26e36d9e78bf11bfa75f444399,python,10,7,3,5
NB_28a7bd8b085fc58f3e50d0d07a55890e8edc0a8a85f75a2462fa021c7e44eb48,others,39,20,19,40
NB_098dc28b64b8345f36e99491deb0842496b175c4c33107327c9419b95fa2dd47,python,34,26,8,8
NB_f7ad3bdeb425899fc1f392199fec14efad590cc50c885552c1622c6c0402173c,python,14,12,2,2
NB_54e26baf4ccb7ced547742e1e604faa6942e72c73c93a8d1bafc2dc22a6150a8,python,19,8,11,55
NB_47c07aa2727f02a325c7085225155320110b710dbb8e9e21c0e4beeacef42e69,python,5,3,2,3
NB_c181690a6b9105c87ff08ddc2dba3582774aac3861f8e338cff0a544bdfa3524,python,46,36,10,10
NB_88b290b9297803044a7993909de0a7320f0809b09f9639e1ce626711c46d81e2,julia,16,16,0,0
NB_644d67e18d97aac4d6ec278aecc0487c7b550303aaf358772d1652f8d48dbac8,python,12,12,0,0
NB_0653a4c19c90440d32c1ec10efea675659c51a23906c5bb8d3ec03f55c677a95,others,0,0,0,0
NB_76a450f725f103951f8f6252cfd877743429ab66fa6729bd906d393e32111338,python,15,9,6,6
NB_0dc6f684c28beb6830b19b568b499ccddf26688d2569550581b086ab5911cb8f,python,20,16,4,4
NB_7bd99bacdb708a407a698c1844cfd0743a455ffe90ab84c76a5b81f4b4cff459,R,22,10,12,14
NB_1220826ad44e0207290ef5b7284fbcf4b3a0870ee118ffc2aa0d148cb0176ef8,python,55,44,11,37
NB_be1c20914d091dc1b953490066fc7b43578357cdf90865027b92ebe9a8e46137,python,9,8,1,14
NB_5a349cec08b28c1a5d8e30746e69b622e42f6220cc19a68d81d0c8128724f104,python,14,5,9,148
NB_aeede988fd23d103a205f0a3167127e1c66a3dfe926c809b17e7dbae1c7fe3ab,others,31,28,3,3
NB_c0fce64b925baef6c34a619f31786f16b33df8614c70879e1ab56da7438a47e9,python,53,17,36,169
NB_2ca40b47a68912d9e30fcf83c2fca7b0913ff9260603b9c2f924931219eccef8,python,34,21,13,27
NB_afbbf19d9c62671d7202a73c1c359336307a58685c6e7dcc2defb46a065eac23,python,18,18,0,0
NB_77c4fb4ac5a635ab57f20751892c02ad4e51ad54f57b6c273d3930ef2525846a,python,12,5,7,121
NB_6ebb36619612dfa9f327cfa91207ab2ff9165c60b1aa0b6ec0fac83a099b9f8b,python,1,1,0,0
NB_1d24343307d6c77f5de82c5ff7098fdc0e3491588579c228eedc31b7b68ff65f,python,14,11,3,5
NB_83df2c96897509c503e185225b889093658d94ffee24fd0b9144cab76c1226ad,python,8,7,1,3
NB_f9395e6a161d7e527aea7d370354f27c484c476814b991db2a4d1e7c337e23a0,R,36,26,10,12
NB_fe12c7d3067608bad11618cafd2433015f7e9ba87c0f2ba92fd86179cd4fd046,python,52,18,34,173
NB_90879e7eea988c9715090c2612b1500101d2450c0869dbc6466f78f64ae94668,python,19,10,9,80
NB_e64089230553ecc24dd88c6123b0a039fe61d6afbc764b88646f2fbd5e6c467c,python,16,7,9,32
NB_b617ad5658ae441122193b92b57c312d7f49396e82ad413ef82e07a70e0a0e9b,python,2,2,0,0
NB_4dd174bd0889bc99ffaace085ab9937c5c69977cdde281f7ddf536bec9f64dfd,python,38,19,19,19
NB_44ad7d0daa25e3f40d3f85b90903edfc42057bfc554f9312a8b9077601d00ad3,python,20,20,0,0
NB_71fa91d90ea12c6451ec85b4b967cb7363c2d750fbd19d7092d3494ba1a7501c,python,31,23,8,8
NB_79fb2a0ce38b92bbb1ea5699e46fe157cb0b85d12b4b6fd46cf75630b92c1780,python,7,7,0,0
NB_aee68828603700ce630d47c38ef86d6a678689105adef89b8ba9cfcb865dded7,python,38,19,19,118
NB_674139bed297cef6d4cb6f82c4f58813fd410ae13cac7ba3429a8baedfaf88e8,python,126,88,38,70
NB_237d318327509d238e91dbb444759c56b29fefed11331a1f1a8a97ee2ab22dce,python,28,15,13,27
NB_71ab6e3714bb53eb7e5973909e519ad9f487def38f7c0dd3da4f7f1d84b0fb47,python,22,12,10,76
NB_0865e48ebe258452cced99a400f2f5efcb51c808c4671898f3927b08931d7b73,python,21,18,3,3
NB_62456ec6b66070cb5c6a73b8d92b086bc53059baff8a7c79dec57dc795fc6efe,python,34,34,0,0
NB_e2770867dbca0df97674eef62831f8c6327fc5baf0ddb6a568b7b5c15793cda4,python,7,7,0,0
NB_d214a5258dc743be9c990f8eb3c03054ea069cc9b37c5613466694c5c4f633d2,python,31,14,17,127
NB_81fd67866a87af1af7ad7d5afb94eb35962d0fc2ad6f2b5801131f99dcb50507,python,44,34,10,10
NB_f465b8a35864527ce61b5aa744147f3a81ebf537ec4da096c1332bc2fc2cef1e,python,44,22,22,188
NB_7be773e74632d86418b2c24c107e34ae69359b50b2baaad32bf8667221b2853c,python,17,17,0,0
NB_86adc615056745b691a7cad6d2cffd4f2449732f7f513a5d3ad9eb450f97b917,python,35,29,6,14
NB_f4b180ca6e35e3aac9448c2305405ea2e7148c7cfbd438bd7d4bd9fb98129765,python,24,13,11,102
NB_141c113909f7b48d23d0eecd3400790a3fb308dd9da32a2d4746fa8641024d90,python,6,6,0,0
NB_25cbdf4928bae628668d7e55fdfb2bb1e227d7ff837f089f7d9677fa4cfe727e,python,7,7,0,0
NB_93ac23a29f56440f1b65017edfbf6daa80af83b2e92cf7080d1353a16a2c4314,python,6,4,2,2
NB_9be7731e4935481e1f30e7fc34264c72b7274a0634ee79589dc8e3c89735ed7a,python,26,23,3,4
NB_9dbfc3e8e31279b41fe0ff8777de54af80e13e190097bd38c4c357cfccad443c,python,114,54,60,122
NB_2cb4f01700051e7d34e7d3b12530b8cdcbad6d2b14ddfb768e26729eb84e2f03,python,14,12,2,2
NB_e1b9cc00ca5d8e15c72489694ca1aac807c76fd348211a090bfa337576a784fc,python,28,15,13,20
NB_cc4ec50054e4aff6fdf81004ee57442cff09fada387d993093fe2711b5fa75e7,others,0,0,0,0
NB_89a90fd70f466e04c6ebd0bbaf24dbc2e72bfe17d43effac40e4b6534fe96070,others,15,11,4,6
NB_ece9fe6c29a7e1e846745c4763e2b877b0bb6f5c65969cab8b10ea6d805f78bc,python,15,15,0,0
NB_289f2a95ad741216fc0c3cc5a1d102616455252e6e4f3e5842fc3da67ee0e05a,python,20,17,3,3
NB_a638fd03a67b871c26e710bb503681ea1c9e8a1d603605385b31776d57f4f4b8,python,12,12,0,0
NB_57a6a1d4f0dd7c4835dbfb5c88f657e425d53c116b66951f513905d4805d7d5d,python,21,14,7,53
NB_5046dabdaf9db16c30d2c152973e78674d7e78f87019010d3e030c39eb331cd6,python,14,14,0,0
NB_9521c61decd4a48646bcc58e4125453e1eac0abb3901a4bd143dbcd40ed671f2,python,11,9,2,2
NB_d147500c47e7711a2700e251d4298616e92e9e44acab8a16f47d7ab2471c04a6,python,17,7,10,93
NB_19456d0d5592d43fccc04edc58a98233596da76103eb2dec8a054112cf1a822d,python,12,5,7,19
NB_c47b52e834d3a2146530ebcaf420e5698a2d9918e62ff114efac085bc77c407a,python,88,88,0,0
NB_bd41945865705825aa8efd0b72df17ae44912b02e156fe8e6186f80628223c15,python,24,7,17,79
NB_a56df98a1660c7f57e8fc1838af2e2fa7658cbb5013aa6623fd9357b1b008212,python,12,6,6,24
NB_53e0a3290813c81faec9c1270db60db3f27d015a58f6d7479d34bc625b1bc8e2,python,18,12,6,10
NB_2c7c86141c202260ed0a0256c9fc3a521a02f7ac8de782916cde7366afeacc44,R,76,36,40,41
NB_dc828ea4861b54b23f1ff460a279693526d9dd58dc0dbc11262ddc9421f22009,python,68,59,9,9
NB_c3af26f45a9d84bca0e71bcc48370732e4ab48be2552fa92be3701cfede8d8d8,python,44,24,20,52
NB_134dcb25544253b33d6d163c0985a6a45e34ec005d9cd24a2086556d3a84e6ba,python,13,8,5,13
NB_cc2c50154ee9b5bccdbed4e119cea93e931a3a1548e7334433ddc368b82543c4,python,20,20,0,0
NB_621bc2f9d6d06fdfa5fa0e64c814e97dbe2b44496e3e5fe43c63fbcf74713295,python,32,15,17,111
NB_9ae64acb2150dbcfde9910e817ee87c15651851c6182657f7a0ee2bb701f01ac,python,25,19,6,10
NB_ab1aad3b0e9415bd487813cf8125191e3dcbecc9fc52fd0ec20f5b55daaf85e3,python,13,7,6,24
NB_c404b8a5fd352758639c2fd0b58f44b29a68c1ac8bc3fb23fdb92ef04487f0db,python,68,37,31,169
NB_06a412d5da68532bdc99465efb7a465b47034e8eb83833be6adedf194d8b582d,python,25,25,0,0
NB_fc6ab10e3e08047480307a6703d3b00a66da679fb2e1eb3cefea1e11f57bcc25,python,22,12,10,113
NB_598f1813cd6fddf757e09c60a42e09e54b9f540049e9b90d6e53f98da1012598,python,13,9,4,4
NB_1e777108715e211b45677ba9cb8fb97a7a7ac5045598a40e3b8768f9cdcf1694,others,94,55,39,44
NB_aa4d6ce58493be179d4420de3e329c572f8e321500387450ea56dd407be6411f,python,14,11,3,3
NB_2f7a101082a835da6094b615e682649d030b55492363ec3a7e0284dd6a1c23a2,python,9,7,2,2
NB_9c3c41580fa13de00558e71405d2d99bbe1de616fb82de3fb66b4f819c225eb3,python,3,1,2,49
NB_45ffe9360d8e8662f61ffb019a2f72c7f75790ecb6c5d89743aa13088419f97e,python,18,11,7,9
NB_ea037b5ab4b62f6b7f142ce377b584feda6e5db7fc195c3389c8a338934c2c36,python,17,12,5,13
NB_8de1436a2a6e9def4f64d88bf100a18cc60f54acc1c5e346b6a4c465a201cbd1,python,43,40,3,4
NB_c354ee653fea44e583ad27cf3272eadefeed0577672bddf153c1ce9a27fc41c4,python,20,20,0,0
NB_4493b38ecb7f6a82fd1d6fb0ea8e06c4fe26ae85a92e3e2a03070aecb7958e59,others,3,3,0,0
NB_4fef5ec0a9babb8deb952a184177a840ea2dc3f5941bbfffaca945b624594c0f,python,2,1,1,65
NB_2f47c84b070ac9aabb4b4dd204d52c6efdc2ed3ea235dd3b58c95cd85e8fe602,python,12,12,0,0
NB_d96259632e3a256015678bb9dce4daaf494c3d9e47b350ddf9215fe4b40e1c54,python,12,5,7,61
NB_190049fcb52dd3b8b0b136797c31424ca040c55575065fefcf34ad0bedfe40ca,others,71,71,0,0
NB_5ebfe6b5b10fce73cce5e51ca7af043a62a1bb825cca6ce1505591083446c365,python,35,23,12,15
NB_6e0e8cfdfbc3f1c4cbb4ea4478a6eee5b777633b42b2f517983b400a77a363a0,python,28,16,12,33
NB_e232ae85c857d828817c40cbb8febea8d3c97d8b893cda2faafee092d60e6629,python,10,6,4,4
NB_4bce19fb969c4d7ace6a6cdcb49b336b8c6cc63fe6200eb08f261e1f6d478d14,python,35,34,1,1
NB_9610fa17e65534754692e25a7b4e3a8df55f714f76a176522981edcd975424d1,python,76,76,0,0
NB_88f10c2ff4bb5a9fbfe565be74540845664d3812303bb085c76bcbbd3a4719f1,python,35,19,16,26
NB_e73f5087eb1d42a60ba369dbcd246d616092b1753c360256663f1ab9f05b604b,others,121,95,26,26
NB_418be07cd1571a09f236babdd4b491314edd2432c0297b0267363f464a0d0ea1,python,74,63,11,20
NB_8a4a0fb6a6133ae4e6eff2cc2f1747ee791417774b69e20d1b0c122842e5929f,python,12,7,5,24
NB_9785fdd21fdb8f9131999bf9e48ee1bf442d33c7af78ed310e036e776246b7b8,python,82,82,0,0
NB_02f9b9565075adcdb9e5380724edf5075033d1e3c65c418986a97ae57af35b5e,python,8,6,2,7
NB_e323e00e0408dbf4a2a23e5191893963e0f8bdd4459571bd996316638dc5dcfb,python,55,26,29,109
NB_03ddc764165a27074661e27954e505eaf5d24e02c8b66e3f7df9707e1f344ab1,python,7,7,0,0
NB_9f17e0809472cf751dcb156cd7923dbf23a74f6c8694aa84c13520826a30e2fc,others,13,6,7,7
NB_44cb2f3e39f1beae5324c98e6c6a095fd96086c273044daecda73e8d5d1e2a57,python,11,6,5,30
NB_1736833e4269d00b4b32a9cd4ab12c863244b93415938aac328bde0d231a3117,python,10,8,2,2
NB_87370aa3780101a58021c2c8203a5b519e53903c7624bd7ee192cf6fa43c6874,python,16,16,0,0
NB_392810126d10d67453b5b703f76db5b885abb5cde126552daf0bfed9a1e75de7,others,20,12,8,8
NB_e4761578c5b915576dde61d87d436d7b0dd702e3cf25a2aa46f235dcd5eadc10,python,3,1,2,154
NB_2832fc2d9bbc734654b0c100a4286dd2d141045a63d70a2edb450d253c395841,python,57,22,35,335
NB_149bd3f39822c2b2c245134f4be41f3d17d202020d71cf2da3cfd016248fc794,python,23,12,11,31
NB_f168e56b8073f8e98b0bab28becf4e9a318eb570733147de1ce8c65b0315f243,python,9,6,3,3
NB_05805a4b4021e3d10d46f1852efa9e084723970f9d8cc8d8e0891167a22ee726,python,53,31,22,40
NB_12b8b489493d59afc60845c7f269c04e8b95c69845047311b439e8c74c94bc58,python,20,12,8,8
NB_4d845d04e09a5cf3cfd21acde9e276ff6d317ad51c7ae1456423dad1d7ec7ab5,python,23,10,13,13
NB_e5896a5c99e20e2c56a73a817f70898916b3c8b27be18f896196896d14746ede,python,25,25,0,0
NB_e5664520d8c759090ec265db102b7e24e71593245bf69d83db35bd06349d3a6a,others,25,23,2,2
NB_642ebede2d5c5d827d2c9a61637b36a07aa8bdb0d874d8c6364af682ebd2b27c,python,38,25,13,13
NB_82c2adf753fd3effbea6997c54356c6351176c9966ec32f67eeab81e934f7f88,others,78,45,33,37
NB_afa64607a24247a62a175fd73416b28fef98c89f7ca5c7cb806d8ac965c9a143,python,30,30,0,0
NB_56e59c6696227ee3a5cf9aa22daad427addd53cf50047c9193bd859c2f243b24,python,17,12,5,5
NB_d19b70b526059d6a173b06fe966a049fac4ee4d35c0334982f839a4c9851fb32,python,17,5,12,17
NB_7936700b00e9da8173153ffbb69bdd50e4c1f7734976ada34eb99818485f86f3,python,27,11,16,186
NB_7f9eeb32c8fc7c74da6dc133e33bb8686a83b0420cc853796cbc54563bc30a61,python,33,17,16,165
NB_ad8a974f7cfd495cc4e6d6b25b921d17f05395cdf2906ca047dfdbf4b72387f8,python,3,2,1,1
NB_ed42917fbfaaa0dbccaceeec528cba4b3f97178f3f8347df91a331d74f2f3ba2,python,34,29,5,5
NB_1c4ca34314c302ef171979994b3654c9358717afefcb32d51a838819b8d02b11,python,151,139,12,84
NB_8799b892068f50580051b29338cf0fc3f5f6936047caf321b893f816c18813f1,python,6,6,0,0
NB_e812ab2182cb152475c3c85a1f44b1af29c30d041e5ac24f43fa3148b4970042,python,56,23,33,208
NB_f49216d38d99530016131f00dec2fb8e0c607ed7d58832d108f23efb113dde7e,python,51,23,28,445
NB_a8a5ea571f1d9c5ed60e5f97d39750fb63072ad51c451396890e626a0e0c9eef,python,44,23,21,150
NB_f43c35e053c384c1e280654e4cf0dec02cb8f727905d637999774af1d4ec37f3,python,199,163,36,36
NB_a7471a6a25b7d3a1d919eda07e808b21a7d0c8d1c474c849992ba57de07258da,python,17,12,5,5
NB_f935f6991511cbde0b2015c15f52bd99231c7794d9d59c7ac1173094f7175c28,python,42,31,11,11
NB_23f7f472526fee4972c41718f690b0e3afc0ae1ca673751f7924aca2c26cd1b4,others,11,8,3,3
NB_5372f2dad2c49993b1b664671f5c62199145b56f5cbf973588891fb763591b7d,python,8,7,1,12
NB_866f8b3378fd4f259c4eea395f33b507eab5fd9e862f8dcf00d784e21c80c4ec,python,69,64,5,5
NB_bde721c2acd84f6d3a705956582e08b3599712192d4ea6f3439ad7b28a484490,python,14,14,0,0
NB_4c1ec38e5fecfad96ee970c5e4b5be224282f3448f41a916b590f6f86db7fb14,python,10,2,8,43
NB_ebc2a831f159e1ae43cd5e8d6669e1143ce1a96ded8e22590b10c37375ba8ba4,python,3,3,0,0
NB_1068c7a8ae2cf1bdcac28b8f7de2430ab61e55479c780ae53439b09582362523,python,33,33,0,0
NB_60eb5a18939a6739471ced78c04cc2f1402b8a7b3b36bd4c2436b7e82ee79783,python,17,8,9,49
NB_a5c6fe7a8d67762c5ab0e00d28c3456120a8d2d1656634a01451362987ddb727,python,25,23,2,14
NB_ecc67935c46577ec35ec1d749b62009bdcfea8ee86ff44c1a03a7856e84f2026,python,52,28,24,84
NB_32b93b67a545e19e6347d9ee2a72dbbe44c001d24a1384f693f2b3709ccc8195,python,112,74,38,77
NB_675cca9c82becccc3770fcb0d4d4ad4c14bce9014be1ee21a2c444e5a2590eea,julia,61,40,21,27
NB_0d6cf35069c1d6f5bca0e87b867015f8f010f6b0f3da219db900fa7a060eabbe,python,29,25,4,4
NB_0570a20c278d7cf3643cae644288b2687da86cf4ea5f27f5d45cee0db4225dcd,python,20,9,11,131
NB_a069dd5573275b180321439096efa52da095ba00892dac2955bdac1a4f044646,python,6,6,0,0
NB_7e1416f31ad35d02d20be389ae78897f8531deefe2fdd590126b53b6485be1c3,python,31,30,1,2
NB_5d5fed1fac0bc4c9a8459170fce761f8c73c14d2ed77f0ff209d048848281ada,python,41,26,15,40
NB_521562633293a1f2366c2b387814fd6899cd7d57d5a50ad3b0e9be49d628cfc9,python,8,8,0,0
NB_dddc16c9905a41b8ea26f854fa77140f7b0a81b58f73f11b43e739b37858e4f7,python,6,6,0,0
NB_e69230c0c15e951ee73646442ec0cd994542677eb4ee185dd98ff4710516aa4d,python,62,26,36,706
NB_7a2c0831c6e3b99325655b941def3357ce64b0692d64583c3246ca1cd634b7a9,python,5,5,0,0
NB_834f2788e2486b203e943888f16ae9ac006660c802c1a6e5a60b075f6f3280e7,python,143,137,6,24
NB_a16497fa5272335143ed7d9518a58b378699f5a644de3f5f5f4e71b63c541755,python,2,2,0,0
NB_7d192ca3fd1118069e9f529d4d2531876e858e708ca55a229c9aa6e324690c39,python,42,20,22,525
NB_d5990f448b3665e761b4b5e3acd400fb8b49c4825039d6ab9fcbc1c232f3597d,python,27,14,13,43
NB_bdcae7e90f0e75d8de8b4d6cf3c50ac9c829ada206e170233e89c85aef728c0d,python,6,4,2,4
NB_314b822d5968125028905bcfc0d604e5c2628800b892ae63a13256d560910279,python,35,15,20,300
NB_38fda4ff01d41eb76c71d7ff6f02866e6e5aacba355671f847c802da2dad57ec,python,182,122,60,60
NB_18aa9c354da99a96f1dc50e43a5673ca67dd1f241c1f539c99871709e9120a85,python,10,5,5,5
NB_4140ca72684a75368cc9b32b5685075b2e0fa5fd5be20779deaf9fb18ef7df1f,python,8,7,1,1
NB_1063e43b691ab080f925acb369a2bedbe2c43e489dce723495cfc90bcb5e733f,python,20,10,10,84
NB_7cb1d7ba9aff8d06abb8f16d2ec2f8aa6c7f3ff0fa57546d59c9b6a9c7d2a2a1,others,54,43,11,22
NB_bd8b18ef18480d5e19bc9495d3dbbd69f5fc8d4a8e0842251a97d349f1356a8a,python,10,10,0,0
NB_c75484af16ca09c8bdec516592b0d0517a641a6a1b0b9498c56cb4b8b3891b19,python,13,11,2,2
NB_8c4b00230fcb0a8e686a46d9464120e78eac152deeab8593d28f6086ef0a217d,python,14,8,6,31
NB_45a727c9e1d168fba79488c9684423aa21cee042ea4294bfaec9953fb5833e32,python,11,6,5,30
NB_d3b790bbce5c58c810dcd7736a3a20475cf1039c65833a50de10f79f1ac0f710,julia,43,43,0,0
NB_a6717b459387b1d274763de3136f10d50da296f8b288238be85c595141682faf,R,123,65,58,311
NB_e9bb75d65902a901d5cb28942505118139c1139be7dd3ab95be37cd5acffee3a,python,10,10,0,0
NB_d300c04dc1a80de01728da5134bed069a697cea5ed2de5861f6b8601aa43b77b,python,20,9,11,153
NB_1ad12f589b92f075661483d9409810278e57157d4fb2265a86eaeafb1873ae73,python,33,19,14,24
NB_7283a7f48f35eb4b4f1bc0a3bb7d8636bb333ddc9e18ce23944327f8ca00470c,python,66,66,0,0
NB_a9df517571861224debea61fedde2449bd8da6959bb592a16cd6502ae0e1dfe1,python,12,6,6,36
NB_0c8e456852f88fd961f21bd0b36218e388780ff9ac3845c7785b4709159fd4a5,python,17,15,2,2
NB_b57b0d671be32768bdafdba977433d561e5f132f965a59f982be45d2599a437a,python,19,18,1,1
NB_886cb62c1fdd27a1a504e3d7344e3e8ef63b3f280a2e3f9537e67cf3bdd396f0,python,13,13,0,0
NB_1a115aa500f93c3778f6eb052b9f55dd0ab75b1ec820483a5a519cd627e60c71,python,6,4,2,2
NB_f242fa4d633c9328891c069c6bba3518088da2366ee150f555f0f35278f8d2bc,python,19,9,10,52
NB_13f7852c7b6fa969cea08e762d17d80ab54083f4e0dc0d38d884881ec2de4ae6,python,55,36,19,47
NB_448a9030abb00c27c07f6bf3a21d50f0a65b3b25eef5b65399458855a00ebd83,others,32,26,6,11
NB_404249af0db4613fe5418ccc7eb2ab3ffcb665e91df98d2ceb41c8815e50c8c8,python,32,16,16,118
NB_8f289639cc940b3b2855d73edfa127e44975842ba81b52a5140c88d15f79bc61,python,6,4,2,9
NB_f0df129819700ebcc6d329cac77ebc38acbe9d3ec6781bce7e18977542029441,python,98,88,10,10
NB_da2d420489604c3164af3691a52b7fe33300b00465757422c93e3e278bcf7de9,python,22,15,7,7
NB_35a610464f1c4b154b9f03db055764f23d49012f27629631e2c6a75aab1b9125,python,39,33,6,6
NB_73f0723a95bfb18013ca69d971826212041db0926d3769eeefb76f4c06eb4944,python,27,13,14,59
NB_4c6663313af670dd218746403be968f3d7729f2c17e7092be531996c4cf661f6,python,8,7,1,1
NB_e8be8edff8184d87ea53f0bd9769c773a1f36a1cdbae9667eab85aaf61851c2f,others,65,32,33,39
NB_bc8a47fee20c695c16ad19cddbf06175b4038a8db24ed7dd81b199d4fece82a8,others,117,111,6,10
NB_ba5047c1af5927f1931b97744459da7158c91b90a079f97b9bc20378c4e693a2,python,89,81,8,8
NB_1b71e1bdc5ad00922ddd003d73fa884685bc26bd75016a19547b5329ba76e270,python,40,18,22,32
NB_7069d9dc1b2c522b6c2bbeec86332a158d1ee570e3f9580d460af81606c2deb1,python,66,26,40,450
NB_afbf18d7cbcecf7b9a6f580cf5887fa83b3f3ae57721016fba13a93fe810b771,python,6,1,5,86
NB_25ed8537b449022240b8b6b6782be9438f6abba99a557829a4abe9c5985630b0,others,27,18,9,9
NB_468ed23c61f3c46ce917203dce4e12172636ad0df69bded48b6b2262bc070184,python,8,7,1,7
NB_76f7b40fee9ca9afa0963f22c634a8d2653e574c955bbaf5e3aa845d21748328,python,30,11,19,129
NB_cdbbe97951047356c95fec13e24b1931340f501d5a589f89b2ca59ba4d045812,python,10,10,0,0
NB_2cbed027689c92c1eace573aab00856173ca3196194dfbe609f262e689f6f815,python,15,9,6,9
NB_57495f68c0395ecf87f965a8a9aea1aad5042c8af7dc4108f1cd1d2fa29a0260,python,51,27,24,139
NB_b4c16c9a4c87bfe9735ae1904469d39b359fdc99a04d3512bb610a3bd6cc8f1e,python,13,13,0,0
NB_b0c8abfced75bcffaba804fc60ea3467a72f21e18cdbbc565177438e55810300,python,51,27,24,66
NB_b3317344417e8f527f42bda534a0da122de24891cf207e35ac8cfae64f2e5029,python,5,5,0,0
NB_851e12786ecba68f70a09cc035b5df89139bb58a2c6f25cecaa56b9767133ca1,python,24,24,0,0
NB_a11ce4d82d349c093c9dc29f8e007136dadafb97556b4e35d0b04ef97103a5b8,python,6,6,0,0
NB_34b32ef16dce67746fad04720b0a9be4e5f0a6f03b9e8fbca80c8fee2e8072c6,python,1,0,1,5
NB_aec2f38d5db9d252f0ff41ce8dddacd8e92f7d8edf6438d7d0ab2a644d411c46,python,13,13,0,0
NB_84e8612030fbdb12f8269b339a72f3e3f4fbab424a35b9c3e6f16f8d447f4832,python,66,56,10,76
NB_3d7dceb46c108e33982da5f710122c48c1150d7223442a87b18e8249fc7e6470,python,26,22,4,4
NB_680fe6b3fb4a8fb0cc57328036de96e32ad45f1b8bb347ebeb530a03828dd340,python,10,8,2,2
NB_db5e0b3708cc681b77cc85d527b71f234de5eef820677dad89a690e8de9e871c,python,11,5,6,16
NB_4158e9fdfcf69d43ac85d117c8db5425162b83a88bd5e5980616802dee5f43fa,python,19,10,9,85
NB_cbcf1513b976d9005ad608bee90b466c8231bac0b09c14ad5264693c4b49dd69,python,1,1,0,0
NB_0da783a1b97ac2ad1be8c76ed1ddc777d4f5476e2b3bbf07a681c91a807f2df2,python,16,6,10,16
NB_67cc95e2749d86f90f457604029e1518b0883c31c3504523050c4c6978d049af,python,13,13,0,0
NB_c76ec0b17d7c7fdde0103a9157b347a3eeef901e094009001e22176876f8cafe,python,19,14,5,18
NB_cc5955b49ece0da42cac94da51ab1be39d00ee3c1ee5e70b06990f65dd00bd25,python,3,3,0,0
NB_f9ca9484efc72531f45fde2aba8fd1c3c5abe5619f972f35e738c4fd2b28cfc0,python,32,16,16,38
NB_e05ddff33f2c635ff092e76bd4d44d4b1aa97d47e15a5ce856ee80e8f375f2c9,python,11,8,3,3
NB_774a3fd61b558fbe9d91acc23657fda42e1b2b0d7fe2025c32fdf82e36634292,python,21,21,0,0
NB_607dcf97f1210159415d08d1259b1eb0907c4646b83a850376e40eac1cc8f0ed,python,78,42,36,90
NB_200fca23ae779391dae1922e853c488b43b5ca7549763e688eca25cf21fd8787,python,22,12,10,18
NB_46beab017b8b4b3ac83c9d8ed93f55e582602241d99b3a866c747fb3a8a54961,python,23,13,10,91
NB_2d803c615e5f7f7c55a8196f974e4df6416d110b1e1099f5dffbcad677640825,python,12,7,5,23
NB_7e901e42f40b07c0ea48441c1b61bb95a3e778a7a12d35b4169ae378b1c3a960,python,29,29,0,0
NB_dedfb702763cace2e5b125316856826a456603b63c01867c12e300dd9171a9bb,python,3,3,0,0
NB_c0147d9511e9d259a1c867efe3d3f6c498578c1d92ffd6cadc34ee55156e4ecd,python,105,78,27,267
NB_40bba34643c79a40a1a3434886dfa451e3fd6b1bf406c5b442702a6bfda7250d,python,61,45,16,21
NB_f0dca266afcf7f68a99e3d876a9174942bfa31a3d3ce68dfcf02fec30d02c51c,others,40,19,21,76
NB_dfce02d7f732b6d340b736ae39956397ecbd44ed497c56af1fab6192cf6624f3,python,23,22,1,1
NB_ae61bedfab33704bbc60ec2bedba7fe738657b54fdeacf2438b949fd2eb478e2,python,9,8,1,2
NB_09b9de57ca756a49dc596081c9e1adc297243bed8bfa55f324a3e47fb51d543f,python,39,32,7,7
NB_32c7b0b33eca3dc6948684a33d8eb4f7e4505064c93fcdd360fb9df2c34ebe08,python,19,7,12,277
NB_7ce679afaebf410aac7eeefc0fb7690e6533202ff6aeaf4c5b6ccc8bdb386ed4,python,19,14,5,5
NB_532fd77603d68fc5b17b7a68673d09673827c7fe26bbf8a7501999802c765c95,python,232,171,61,140
NB_e835d5a02bb4d7e957d547d0f408004677fb8e16bb62312b9214b7fb691ac8a8,python,13,13,0,0
NB_eb50dee19bd2b58f912afbc6c18b7ea97e56704c62adc18c75e896ecd7f615f9,python,20,16,4,4
NB_3d74d3d6e5d7ee938e7b6b1ab075e284c5e956d9fbb7a2a1102d82e8f768a5ed,python,14,8,6,24
NB_8492beaef22f2aa0e14b909df734d2f4e9e6dc6417b912c751f7c1d78f828837,python,4,4,0,0
NB_65c9b51cdd1a842b8c222e57eeb2010131e896ec6abd34125d64788bd62c45ac,python,68,28,40,854
NB_ba3ab3f35bff52c6215356d6f30f3c25ceb7aceefa0119eefa0df24d97d400ec,python,89,69,20,26
NB_9c0e33b63dae459e05bb125ab9cc6dbbec73cc328aadb6c3ff5f7fbc67c18bb6,python,16,16,0,0
NB_1d0d5b7aceb1f8f4ce615dbf01d12aa518ffb6131a630073cc390e09bcfb66eb,python,34,28,6,6
NB_99caab6a491b6eb7d1b1904765fb43e8eb6b9dcec9808d70f8c617c2f96e07d9,python,21,19,2,3
NB_e6631750c81838e8d24c933e475aeea220942b1f74693eaf065031005986b4ef,python,59,59,0,0
NB_4211ee63bb84f157778c6254450d3e879cab5eee06ee356f1fcfe7ed3d5e7961,python,46,23,23,65
NB_a07af8dbe47bb3b44a05c9c97713042458eaace69976be4b9b3bd598efc8c2b5,python,2,1,1,61
NB_f10dd6a8815f0f3406cddf7d3aa337335982670c694e5891787d4a9ce58010b9,python,147,113,34,69
NB_78b0090ff47123765abe2df1a3ec9ab5827464370df4efe00b25a9cc83b08a06,python,18,10,8,8
NB_ba8286e5b652d20c677a6114035f27896367d75d5bc30b4094c5087e1a61f30a,python,41,36,5,5
NB_c9f248bb3c4f971558a8d9cd707db8985ae479321df007da957b8d033392c28a,python,29,18,11,31
NB_fe14c147e08f1082612a2788da2b7cef9f3366aff976b12212397ed979e46ca5,python,19,8,11,181
NB_9046775867e463be1bd044b4954b2cda610326b10f8e2b12b473121e13f5902a,python,140,87,53,193
NB_9b103aacea16412f161d6ecb65af87354c09977dfa2ef1d3c120c3fded318b11,python,15,10,5,5
NB_9a88e62ede52926823052c049393c1b662a99b921f9fbec24ec2553758d6c40e,python,41,22,19,453
NB_e6c1a308cd91268b8b3cf626f58b9df6882027835400915a42c0c5ca1b23ca46,python,33,18,15,52
NB_635238993dd7ded27cc5db3e5b3f5ca0f3e75c141bbcc0b5593a9abd90c1b30f,python,16,8,8,13
NB_c19747db7e23c634e3db9783bdddffb48206b86897b41c08674cf114e0edb660,python,15,7,8,22
NB_b301216eaa439a0b9494964bd6f8ccf59e872116efcd37eb7b1f909df1852948,python,145,130,15,14
NB_d9bd1b6575eb3617f1f89904b65e1159cc1c8f7e885226914bf461d483b7043c,python,27,21,6,6
NB_8079516372919250deccce958938e83ecda6b4ebc490f420b1aed65dd3a8a1dc,python,29,19,10,5369
NB_96a6421072109999f45c40959384699481b745fc77ced306bf8bae2d81d2730e,python,17,9,8,19
NB_763b29da8be8e476aef8528474f5d9481d47f2553beedd5c0948caf355211396,python,18,13,5,45
NB_d4ff9cacf5d4b758e63d7e45cd6da08f3696e7610af54d355add6e9cdbe1d45f,python,49,25,24,170
NB_d5de020dd6a7a8ecb059671d440450efc5bb509540c32152480a38713ae5a1e9,python,4,4,0,0
NB_b8809b222d6f95810bf6e79afc483e5500e0e8282e790713c5b21cebd40a9e88,python,9,7,2,4
NB_ed51242c9ec7b4951f8ddee845b91808437c1465dfa6bb0812345c10f96e4fe3,python,523,404,119,126
NB_3c68ead1b648bd959bc8b478fb662a71aea7ed50b7dc2c2089670191523247f1,python,71,26,45,325
NB_4cbe01313029a1dd6c98e2c2c25f9a97265542067f1ab8f81fe7e12703bdbcc2,python,20,10,10,11314
NB_488b75a1f36b5bb1f17dae39b8233f51556512abd3db968a3c199d1da0758451,python,70,30,40,149
NB_008fddf316954c32cdd6e82e0ef960e48a515f49d1902d46f5dde68468aeaff2,python,15,7,8,14
NB_b639d2b48f6b4a05f42a649b53d767c1577060732ec982b57b447a0fc8c00b2b,python,23,12,11,64
NB_c863eee6e380687c56ab9edbf06a272d38072a003770f8e8f0eeea6f4f67ac7a,python,18,8,10,196
NB_dc155779ca4aed19b074272a1d104a7e004b05c575979db78de7139a10b60cf4,python,144,115,29,29
NB_2f1108e233ce5cbed139bcb6f7873ef6589a07462c905495886d14e215f792f8,python,14,14,0,0
NB_9ed915e33fa6c78c84829dac0a2e28c65a70f126ac4d3c1a873dfaeb2d2052f3,python,31,30,1,1
NB_9de85522fb322ddc27d012b6ae8f471d5cbd64840951e26b9e6d3c04112f9be8,python,36,36,0,0
NB_e04a39e25538483237e4581c606adfd62e5839a637165fa76d031a70760fe36d,python,14,14,0,0
NB_b80c96b1be8df54784456375987d1b27a23abf38e0932173b29ecc648129983f,python,21,13,8,11
NB_12cbd97c505c29edcf53837ba18758eee7872cc2ba0119f1e52c5502c17e175f,python,30,30,0,0
NB_e2052004d4bc5f9113889a7d3c2d8426e5f202755e378132fdee008fdddecd27,python,55,18,37,395
NB_ac251b0f6636677eda950a46f6eddb6feb123fe87fa70c2247e2e077acbd05fd,python,69,61,8,8
NB_562eb94054dd9e5d50ecc0adbe19beeb07dfc84d3b6a4e6ce75ad99f712d903f,python,6,5,1,1
NB_ce47707b64f0c8fc5f24838b8c18a2a98148058e96d9475712782ae90b0bf4b1,python,4,4,0,0
NB_db3d66e2cf9c3fbebd95693cc2d73e6d7a4edd19cd661e6fbe74aca8cc112d21,python,28,24,4,5
NB_830b58394cb009d0efb19a1b3cc17c8df097e50966b243658ab468d6c676ecfa,python,5,5,0,0
NB_8a39da629e4efd36d3b37725b318feebd07a8817e06b2613b8cf4a84b9176a51,python,12,7,5,5
NB_56861d9e993817018fb24439811f7527bedad0f41edac12f1f6fa2fe7563d10d,others,5,4,1,1
NB_ce1e532130eea6c6b18d74a9bbfdec25db5a11afe13d6df8c334437420e1fd35,python,120,58,62,439
NB_1336b1c1f4e504e343cb4ead16fac56da8abc98912aa6d035c37ab0ab3c47256,python,53,38,15,63
NB_636d71f928103504c032f4cbb0929172876ccbf7fcfa48aaa0e9637025e94b52,python,22,14,8,122
NB_ca1fac18776b3fd58ffd85e53963dec6dc2b7d81dbe7c03b560d67a81f8d50a6,python,25,14,11,72
NB_f7a8d9eab4565eeb35ef11def4de297bb338f027b1077d05a113ff53dfcfef16,others,0,0,0,0
NB_fb819d6d8902ff4d216b1ede3bebc59861535ed5517bd50a4656e099ede5b99e,python,19,0,19,268
NB_5e57aed3adf5b7525b6eaddd6d3372eaea4722bcb41e78cef9d66a174e1f5d37,python,80,45,35,130
NB_32413a2362c40b9d32a162398cb688a26adcb2699e6a70c6a2b219d24b4e91ee,python,37,22,15,21
NB_a76ac5cc598edce68906fd7d98a65fbd90660f9d136df266a9b025c54220f18d,python,12,5,7,90
NB_b05592b6dfa522a1b3148792d8a90ec59cffcfa3102fb630a03042855815dfc7,python,1,1,0,0
NB_d5e3e005d75425778b130b1389913ca6292ae398f221df49e2c3c3a8ad5d52b4,python,33,16,17,106
NB_89ac2da146ffa6288c1ad96f87e5aedd5aef24cd0ba7a258fa06ed1d57957950,python,26,14,12,108
NB_113ff1200914c6e7d696a8c300ac4677725cafbae0594e369c762e428a91069c,python,18,10,8,8
NB_0dca79dcf746cbb4b57f744621d07792b9f5ec5d90c695d17fb8cf1ce2e2ac79,python,15,15,0,0
NB_286da040355db84de197cc61960a979ed8e8ec374b0ab49b2146cd699dfaba9e,python,73,49,24,114
NB_6a97014ab92823bab21bd49b3c892496f3d1f7493414775de00ed55cfeaa8729,python,14,9,5,5
NB_054bbb0bcceda12595b9cfed3fd446ef6955ddd470c55c4a6c0845f3d916acdc,python,21,21,0,0
NB_b4b8802acb2bc00e96ea07110a4302aa95dca8bd5ac67cf0d1da21b197c21f17,python,19,9,10,52
NB_89336be6e288a6b040bf341f74df7f19168718b26e5099d5fa238d1687e35d32,python,29,15,14,22
NB_ecceb613bc2af0fbf32123a54b5b6da432197339ffe308c45f284551b1d7304d,python,10,10,0,0
NB_606196e32303dd38594f0963fb6834282f290bf205981807f3e3d390cdfcfaa1,python,44,26,18,184
NB_f516900d8a92f8e6346f864b518b4bd5c0f39bf840ac3231edb43922221d9d82,python,92,67,25,59
NB_0adc74db43a2c1101ba63613e498753c4ead3c4f632d3bef92104148ce901071,python,9,7,2,4
NB_870d6eee092b32940a7c0a75771cbcdd63428cf5970c31cba0a358b5123159b9,python,27,23,4,4
NB_8940a7fb4cefc3de82f752a1d08ed3c285c5e31a847e684ef60db8463645375c,python,47,47,0,0
NB_6d46059e652d995f2b61d8fd890ebcb2dd79914c1be949346f19cbe23c5d0e3c,python,75,61,14,23
NB_189f7a79aabafc5c13efe4c25c3c4b91a1c539bdd40987294b16128a91c70564,python,54,27,27,177
NB_9894181f6b18adc1a0b3d467b3144c46dee8c6614e97f0b49d8258fafa1b64f0,python,41,36,5,5
NB_112d045a7e62292d13bd21cb13aa1f3770c2c4c088f9b0b0d294474bb1c067bb,python,25,14,11,93
NB_5f79b137eff7e368f3a6a4dbe69b6b0172bf79dfada8fcd5a6e48ef6e7ab52c6,python,24,13,11,37
NB_c26fcf2cc4f9e378f4f752f037dadf6d8b783f5518ddf24b5ce37356e92df412,python,19,9,10,30
NB_262429f004f0664769a7eeb4a3bcf7516e3bddd9b9a977e64d82b8371252033f,others,14,14,0,0
NB_ec6ef17fbc05d1b5110a16bb5d0fe42bd0dc7e9fe86df055cf9112af5a6b2435,python,14,14,0,0
NB_0cd70d2bedd38ced27566ea317a939a79b7c6ccf67122b7c057a3bc6c45d965b,python,100,80,20,47
NB_b03874b8ebbf43f02e37416f80eca0fd4e2168add3e3f22b2a47f279ecda14a5,python,15,7,8,128
NB_21ad452eff0183934988c10a36ca0490f02c6fae74741e68e7f2762e016a8c6a,python,64,44,20,20
NB_82e301405967bf3b8949264def815c3c51c9a2c36530a3c8c30ff93808c0c9ce,others,62,47,15,17
NB_1ebb8cc577b48e95d80c01e618db52ad8e9067bd17bcd7499fcf6bc9f5294e13,python,4,2,2,9
NB_e7d51f3acce3b9dcfe4bfc97baa9b8cc6511e8339207d720beaf552715d9eae1,python,177,144,33,33
NB_6e780fd18ae07395e5cc9cdb9d3cba704bcd7df15fcd8c225682c33844e9f20b,python,27,23,4,4
NB_ce24419503a3db916527c20f5c71528e99fe83ae2f73bca3a28d9ccd5fd54dbe,python,16,15,1,1
NB_cebfc92f098fb2e00e4ba677f3b84ec4f9a7f705a2068e16c05c22bf1e3f79a0,python,14,13,1,1
NB_56e7081f889b68ada8b4023b9e158550dcb5e58d2a52b98145a740682aa8a1a9,python,86,41,45,706
NB_64aac926ed662f9e7680db665a0d69e316b2ab44c7500df38f4fc0d60feef134,python,21,17,4,8
NB_c39d4260bcb04f5978a9474fa8aa218d37ef87dd70e1616c911bbe09090683cb,python,27,13,14,374
NB_5247595deb2ab1229ada649ae86413d90ae0b28afc55ac27e9ff27edd2157d15,python,35,31,4,4
NB_398e5ca8bb40e2196548fc9f52853cc8fbcdab15297108b024e8616009fc325a,python,14,13,1,1
NB_4b19ae5316cbc203339661ce961e29883965203b45ebda52b1028249d9bc9c28,python,3,2,1,1
NB_a539cb7f51292ce5bd2308881a63f0c256cb6040c8c2e2a8184ddbcad610ddd6,python,55,43,12,12
NB_7c4ef1486d753686e495e0dcc348603ad5ac3b0f944fb14ce471af752d0e03e2,python,1,0,1,112
NB_6750be932d3dadcfb4eef99966fe24f00415fe1112bbafae880ca39f49d94b6f,python,88,88,0,0
NB_b87e417f729b8f0a27d6986ceaca8a03a35e955c651bc962495f30b148aa389c,others,26,26,0,0
NB_51c56f679052a22ab3898a8766dfe32b8d2a70d7fddb675d6d0020e38f4a5ea2,python,21,19,2,2
NB_8aa461205c78d4b5e88c19880e24d07e1efcf6f5a3527815a53cc44f603842c6,python,51,38,13,15
NB_552a732063ac8425b3d7f22e54d20f6aaf043219cd1080659b0f32d26cd9bd4c,python,41,31,10,57
NB_8b46cbe76ffade37ea4809041fb4bfc55db5cc5af48b6886bae325ab217c0e59,python,44,28,16,19
NB_ab3514e83dcd5064e4b964afb1fd81079987d53a5c58a0e95dcd7cc4b491f196,python,95,61,34,158
NB_7092be7fdf9848ed954af1ee4ade6d5db2b493ac4511b509c26eb56bbb07094a,python,11,4,7,61
NB_2c7eea5ff2c9ec97ec0039218f5315c78ce535efb27d64f812569cad00b5679d,python,8,8,0,0
NB_b96befbb06af0eab7b2d0af82ecddac5f8842ec255708899624cee45fd2f9773,python,20,20,0,0
NB_60caf48152fbd799577fa56879a0d0dd41dfa65002238c31fed3e358f5243ed4,python,71,57,14,22
NB_f3bf3eeb32073d1dcbaa3a7c76bb0129c1e6b8a626fa79c4a7936b79b44d5729,others,89,81,8,8
NB_d1cd3386487487041383e9c747d0df3286645897b75386953f2be885a52788b6,python,454,194,260,596
NB_93bef15522be803de45dedd9b219fc4aba9173f5615dcd4a674d058a2740bcf9,others,85,74,11,59
NB_3922dd72989f1f73cf468feb9c7bdb5023206de55abbe20f45f64b620f4cff73,others,12,11,1,1
NB_130fc1b8a1ee01ae9dd7dcc0c42795512b6dbc039c8d7264d3d14ff4bfaffc06,python,11,9,2,6
NB_57cf719950933384730416863a55f1ea341480b192291f5ba5647c8d8280cee8,python,91,61,30,33
NB_b3d5cd820c11466c69bb338e249f53624f5621663922829af5dec5bbf00d053a,python,37,37,0,0
NB_2c802185418656bea438bf0699e6efcd2f608c7c9a24168be095ddcdfbb20457,python,185,90,95,356
NB_0e2e7b079506d62f091ffa7d86f9e5b084e24e5009e0ee912a8779205ca51117,python,4,4,0,0
NB_cd616a970b5971bd511532baeb443afa9d84351002f7f717fd2528e3af4a7924,python,14,6,8,8
NB_38eb570ee28f35c4637e0cf7f9f21eb46efb0b86c460a2d29679f4cd71ff846d,python,8,6,2,2
NB_5d67c4c70b64e6009750bedb4665c87d374448a634739bb61380f7dfbff8dfd4,python,21,9,12,95
NB_16ce038b666da92414a98aa0b9d003a894ba59fbfda891a80cb61ab044f030f5,python,38,18,20,34
NB_4eed0f1bfe244f258ef09c92bbc74ccfb44d7a7e54951e02fa549d7737c50934,python,23,17,6,14
NB_8082a7a09dbc73af50ecf3c7998e531e5eb6849e6cd3b55cb29ca9d554adfb2c,python,10,9,1,5
NB_11b1ee8a5c5cfcb08dcb0b324ddb37cc07b31deaab12f6ccee2dfa2a6ab897c9,python,23,15,8,18
NB_5fd6685a8218fb26dfbc894c7943815bb631e80045e64ce4a6a8ebfdff01e741,python,34,18,16,141
NB_4a34c84d2121aec3eb0a7c361d8858ec9bf3adca049f319314d3a6300e37068c,python,16,14,2,2
NB_8ee236f05759a5ef37a79f01d7d91d9ec12440a5aeb06565c66d832d19c585cf,python,6,6,0,0
NB_b95bd7888fd97443cf3f86a019c8c59700d6bf3bb7310ca697f6a1254f78fd12,python,40,21,19,191
NB_4c2a5a641fb5dfa0728156b710313c6208a0275fe4b82cb2673a31bda4147c23,python,41,17,24,499
NB_419f4ece6245aeb2594acebd6d5ab0c9755ed49a5e3b51f034001652cea51357,python,2,1,1,9
NB_6ca31f22e18c58c083d755de421c6ebb3dec1378df8de53ad238172505ac033b,python,91,41,50,249
NB_8c9ef4cf6e1a45f739b282cc3c57c0bf194fe16dbd5af7b856bb82c9326e8d9b,python,18,11,7,9
NB_3c510146a351685ed971c62624d039e3b5d8e22203565376e43d8d478800cf88,python,26,26,0,0
NB_aaea0ba380a89ee9873009fa8f041af0a3a5dd1e8e3aaee1bdab1af635a4bb5c,python,28,26,2,2
NB_6aa8a10917c869fbccb0102601707561d4aa61a3b2a6bba017b6cfed6468246b,python,14,14,0,0
NB_981ebc4fbeb9295ec2b56d073e219e7f695601c6dd08ab611fb10f720b27f66a,python,16,12,4,9
NB_734296cbeb861631247080cc367c9e6289bdcf6032b15d695392936cd8dd946a,python,38,38,0,0
NB_cdc7ab44e6ee4fa1fece8cbd7632c40c3cdc7115fda8892e989c3e38c77ed4cc,python,11,6,5,5
NB_9a885a2e44a55b6d9cf0b20d7794e515f46074a1014af8518bb0603f22b61313,python,41,36,5,5
NB_6a130934bd461a1526dc8f84737436a027bf3bc0695e271b8bdde367022faf49,python,24,20,4,4
NB_dffd3c8f6eecb1bd3e570ccbd7aba17d21867e24d0072fbae375bb193cc6bf92,python,19,9,10,52
NB_6dc9abf0498ec93bc588ed5bfb72163ec08c1f331d896c7c547a1af0821df550,python,10,10,0,0
NB_b59f406dfb779c5c63314f5d3a89ec63cc630d79e6b865ac379bcf73a9e7c007,python,32,32,0,0
NB_a48408b05a2efcd6c135a5b20658866eb8d9c17ccb8f2b5ea65bfcbee0574505,python,58,50,8,8
NB_3e7fb65634bf0d2b4ba644b020ab40589280883d342d4b09cc4727cb2391b4bb,python,79,60,19,74
NB_1b230038e8df66889c989b3d352063c967400b1c94225ae6dcf1bb65b486d320,others,69,37,32,36
NB_addf569384f1c98f8b570300a0f8fb79fc12f22603345c8b220d3010eb1aa7c2,python,1,1,0,0
NB_9583230daa1fb6e16134580b38dec1aec1fdd12113504def8941e56a76937789,python,32,15,17,66
NB_fcbb2f9c0befe40f11cdf795907103ce046d6d10141719ff40f1d9c6907d779f,python,43,22,21,187
NB_cae56904063f17d09f941128f398a7bf0050e2daf87f097fe81b4345878e776d,python,474,358,116,123
NB_3f7fb8320be9c85e744426b9f9ab171aedc8c91ce828e99bc5eae2db35af90a8,python,51,51,0,0
NB_bd8136e4991d7c221d799323a0a35751a23a63e9395b709a68e043f4f106888f,others,41,36,5,141
NB_7d3b1b94ebbe783da96cc0f0a6d330c5c8be863fc325ae55a154f45dbaaf950e,python,47,24,23,92
NB_f30daccfa2b7b6b22fa79c272ce405a20202235313f44b0e8e297f6cf01588de,python,5,5,0,0
NB_68c5d8f9e7c38ea03bac9da90124953e96ec64975ab89a3db225e402da46fa73,python,8,8,0,0
NB_95d4eed11291cba6c449be9aa6944caaa7cf10e945e3c4172f4d7b71ee703ea3,python,24,24,0,0
NB_f07fcd7a8e909426bbfa8e911d674a55e2f82465dfc1c8086d29317526662ce4,python,63,38,25,161
NB_3f87dcee6efe2021e2b2c84f0fe51e97395793d479469a29245f5bde83aff432,python,25,18,7,36
NB_a78494292621c72520c782ccda81b31d526c37fcccd863725d3990ba5626cb86,python,51,40,11,11
NB_6322ec1c45b4a402eff1e53c1bc3ac6cfb9e47007c9455e2c2fac6135c020e32,python,14,13,1,0
NB_0732f30d15fc791c78a349de42035cf189cdccf92513aa77917ebd77c77d6021,python,5,5,0,0
NB_c1092af3546f303528e6febdb5c448518f86c5182bc65951ef8572a08c5a0326,python,24,24,0,0
NB_e31e0ff44ec97a7e2146a16e680aa7eb54e219fe364e6bfcd02cc13c8a11da58,python,45,27,18,182
NB_64d5c22469a35fc698372fbdf56ad2d190e2cc1fdb67939199ef3e2cb57a8c82,python,24,9,15,36
NB_5c3c913769ae8bcff1dd7df0df462945ab54a39b8880741bf684f7b550e2bfc4,python,15,8,7,20
NB_18db0fa83eb4971028808b05d47e22b41dc62e8717bf3376c5677759be1dc3c5,python,8,4,4,22
NB_3a2bc9aab44ddbd502f7702e1067019b7352df91279d92925156b3f20dc6e6e4,python,548,256,292,409
NB_3b68745e5766fdcd574c040fb7c0f5ab42a359e75488aff006e0ac2b784dcbc2,python,3,2,1,31
NB_ffff27e74793c46ea1f758cb95bb3702f2d1c96075d1767e0f9da9ad394e30e2,python,20,14,6,14
NB_c5c74c3d0e0e0d8203c455af862a4c58934808762a6d75eafc97d0fc64d3cf5f,python,24,13,11,33
NB_a84356cd23ee832b62d36299ab7ca33be8699ba290192073614910976d06d104,python,14,9,5,38
NB_4bce952f5f43465b2840f848b9d5fd38b78f620680aac098c6deaf6191486d87,others,29,28,1,1
NB_9a27bfda2d580d570fc736f1c25d5277502212422d48929fbad441f3d3e721b3,python,29,15,14,22
NB_930794b85a80996dc260dddba2eb99c8f090980d24fe32b8e22798913a0325fb,others,19,18,1,1
NB_5a360d7237c7a8b4e42b826c9022ccfe590d4eb846f92d11331f5813e5aed14d,python,22,18,4,5
NB_c15b4e9d1c3918d5e157f10c2bb29322b2760bae7f131afc388af74d749aba49,python,15,14,1,1
NB_55cf1e2c5dbfedbbddf36292b9141ecf8a5f61665a4823c47adb947749679744,python,21,11,10,20
NB_a20336b6841a49e9d7594692d18cef88506c1a3891cd1063d4376ec4ded600fd,python,15,15,0,0
NB_aa6648ef2368477c4cc7b50a22ae78686b989d6df20efab21df4af6c896ced3f,python,108,42,66,672
NB_b411b3ea25a2587c42cee6eb6a74030dab39093fa91348bec1d3a1ce4aace3ef,python,45,26,19,26
NB_28ba347e3bd5a15f874098063c0978300abb0df872c06b3b53716706a30e93af,python,21,9,12,40
NB_fc484656719dc137fee574a5b75ebc2e6315bc5edbca641efb571e4a650a959f,python,26,15,11,120
NB_ad12ae5f9f6b1bd57df157f11b0c3890d3c49be5b0642afe139e83b2a5eb1944,python,34,28,6,14
NB_a7d9c823e013c9588bbd21930eb83350f10d71da0ab936e5d1a9fe98f3f5e6f4,python,27,27,0,0
NB_003d541863ee0900f7b1dc6fa50aa50fb5d3aa104f9a2b8247b3d9a4d96381f2,python,4,3,1,5
NB_f9c0d25d4c1b3dc0324d9b93f8a7ca6aab14465165f81f8b82f8df5aafcd2e64,others,4,3,1,1
NB_58efb59fc3db4e784b766c38f3e5e5bdd922314217d370c60240626bb6b965c2,python,26,13,13,200
NB_fb2efac8f6a848975c5b3bb12abb37f8b261ce1cdf224b3f94202aba1c2a6a00,python,72,49,23,35
NB_b6a23fe8ce0d6aa6c6f87296abd680a81a0bad1d18d1d87f75661dddcf6e1729,python,28,12,16,29
NB_fe3eeed8e974963abfa1dd6876ca298d6c6507db82a4f46022b218cb2debacd8,python,10,9,1,1
NB_20980647c8b7af371f45ccc79adb112b32ac3175588f2216b320a255940861f8,python,33,23,10,464
NB_f701e228996345973808112fe3d81b9b7053140d64271c603a3a7af115d78973,python,13,7,6,48
NB_018de1c46cc64187ae23d14b1a66995fb324d76cd516daad244851965ee6ecb5,python,136,107,29,29
NB_87efed6d28a55191cccf006bd66f9815d726d2b112ebdb2647cd1b1f8bc72e0e,others,94,55,39,44
NB_d21b3f9626fcc58c60deb384be131b120f03f9ffca7e9b96b7fb433be38eb662,python,6,3,3,3
NB_cc636af8b977c80ff539e468d179113a13fcd1f0804b31f5cb75ab39f95d4ccb,python,40,33,7,7
NB_c47eff15666efca7a9837b2ecf979aa970dc8331e68c5c04b2fc7a95835e4e11,R,72,26,46,46
NB_6f1d2f566a4f8f3ce0d9c26b675074807834e8f48a5abaf58abe7d39083dedea,python,27,24,3,3
NB_1942daa9d54978e6f0a6521ab3c7b847d47dbc94754e0dbde4b039f2d69c702e,python,11,7,4,14
NB_b8fceeae8d0c3390e16564e5acc053165f996213895815254c6b96e1a0a5f5ae,python,21,20,1,4
NB_d622edb45052be4893baa2848de11de20390db94dd450c14765128e0a185a959,python,25,21,4,4
NB_ff24c9a59898310b4a8660c2d7cd12e3c5a0682102c9a38c59c46092812bdbd5,python,20,19,1,1
NB_c78d8403811786c7995466f151c099790cfe054d286794b34dc3419a55e7ef0f,others,117,111,6,10
NB_1a8743f91b8a7b429f2c89485095590a5b8aa762540de45f2dc9ddd918eb050e,python,30,12,18,115
NB_c52e03197acab9db415780dbefb8c40786d756ac0974c3050860dd648d6d8f01,python,12,12,0,0
NB_25bb66e4b521323fe44fc46c6630cbb296599cc040fc4accc48e2061daffbf38,python,7,6,1,1
NB_c8a1d3fbe93fa782cf4f388d6d590dd56ff8b7799296917b55147b7e00f162a9,python,15,15,0,0
NB_1d45d74f69a7108da71498d0d8ad67849f79b39b372c8d6bc0c3bab24353aa6c,python,60,28,32,254
NB_e6c1cdd8f5371ba510dbe3c8ac0c3d4659e5b1310e03f12ecb18f26a68cf1784,python,45,19,26,46
NB_bc55c9ca0128fdf6460ecec860376117e22a3f83293a45556c8d0747a74d0b9c,python,7,7,0,0
NB_46707a60a5954fbcabfdd919aca8cc9f4b2c917a9ed725357e84eda4a3ba2d12,python,21,12,9,53
NB_12236af8efb396f1efee35efa2e57e76d20cb185bd95c7f3e4cb067b74849d6b,python,4,2,2,2
NB_53c546d446d1094dee694b44fac6b0fd0faa9a1b98803dc33f1739dc7f825a51,python,29,20,9,9
NB_893543d968072a94144915348b9ac107361ae4d98c553cf022416dfd62c489b8,python,14,14,0,0
NB_f85fa36b1d02852bcd57f50542835860b641d4bfa6b3a82279c64629bbdfd5cd,python,14,14,0,0
NB_a3b43cdcda466e0036527d2b6381a5f26b3ed9eb2060484a5529835e96dddb30,python,35,25,10,15
NB_3e3474fe2a0c6f1cc3c6fba5f19849855889ffe0290d8e818ac13f2634f630b8,python,8,8,0,0
NB_e83389df22d427608d810bee1e674790b401c09c65d9975370ee50cd21daea53,python,42,20,22,196
NB_e64aa20d1a157ce82f7baab9d5b9d01afb278972c62d949a052e190d25b10966,python,23,11,12,113
NB_9c853aaa5db1c59035dc28a61db1cd57dd0a75b84fd45d92e0c0e88db760af8d,python,63,37,26,26
NB_17453cd2611eca7294ba87ebcf8471cf91c7bb4a66328420e3a00f5bef0e05c5,python,7,4,3,42
NB_775cdd67171fd7d050268572775ec9c76019a85dbc1b37777498eaa0273fc779,python,13,12,1,15
NB_a7685b58be4d58e3690dffa0a2c84735a851f61572170d60de7b18f7caa20493,python,16,16,0,0
NB_02e91101b5270ae1990ba201dcd47e66c17e96a86c80a7e5037d26127e6b2790,python,30,19,11,57
NB_217623e292bc2b243bdea3762bd443440f9e0684f10e9f2c67232986d5ed5865,others,119,119,0,0
NB_5f1bb6dd618dbeb193e5321c0d21a80d784ef81e555f56425ad07450778caece,python,22,22,0,0
NB_f9d5fb857db3c15287f727281823d167996b7179b55fcfa609d5c355cb6480f3,python,23,14,9,16
NB_b276cd89de8c38d223b78e503027d6d256f12171352640502ed58d8340696c78,python,17,17,0,0
NB_15ea9c6bd78236643fcec7d87cd601f16f8d795eb14aab76839a6a0b7a10d207,python,47,19,28,168
NB_9dcb16e2f34fe46947b2c17c56f98292be16b2e9cd5f7cd2f94807aff3dfa424,python,75,32,43,321
NB_deb568c68c79872495ba4dfa93add98e53ec6863f41006d4b39f2f69586c3a74,python,77,45,32,314
NB_a77d0b0716a9e434c924d5a4a1e288186a9035c65e7b887c6bab3370bc59b2ff,python,7,5,2,2
NB_c2001f521f4855a4d4aef48d7b6a42cda4a43b8abd199e31393f4e89286fcd39,python,24,13,11,37
NB_6f8d59bfb7c189316384a212e6d986e2caf7af058013862e7943cc5595f3dd88,python,12,7,5,37
NB_ae0c209ce201e5b17d2429095125aee168de7f42d65c217f26b0efba666fcce3,python,5,5,0,0
NB_ce2e02c36c4803e3d378b739931e64acc13a00c6ff1baf68ef2d47d7ac6782c0,python,52,42,10,13
NB_de4b9001bda5ab05a0273a786007fd144901f09bc7607408ccc756f413017554,python,35,15,20,248
NB_ea8a81cf3971acb3ff36214755a299facddaa30b52476c1a805474a1eeb64c98,python,55,26,29,45
NB_f60b62cdcf8eaeccdadd406f73f336768bc197f0dbb0f934e559aec37972f96c,python,19,13,6,34
NB_b69e253dca34c9211985b43e44d7736a593803a4833bc8b67b2fe0d9c35295d4,python,5,5,0,0
NB_360c39d07d5dc36a6c355249903f883e92c5a42d9014efc81bf0c275bf12c433,python,21,12,9,27
NB_d13c16cb6d42142ec4733d2c248e04fa618cfe501f28e6ac1b8ad786a9f65d77,python,44,20,24,34
NB_3e200cf36739f3ffe262f738ab5988974dbc396248ad503a46c50ac70de25619,python,13,8,5,5
NB_7ae82c782f4fec1eaf0c7ef72acf575b76bcf7043cbab181dbd138f1b7aff634,python,128,120,8,8
NB_434fd3334e45885a20912c185f76a71839086082a1a0f389036d5b6f1d5203fe,others,78,45,33,37
NB_1708aaf84deb43f072a1c144a18f6a019415bde2794b16ce923136866dca15c7,python,74,54,20,30
NB_e010e2d74218c7bf6930e09de24ac07c75d7ca7cdad8f12c2819166bd622e4bb,python,14,9,5,9
NB_336ae8674cbc9d1923ffd9b950c9fdd9b75b8c28c8aa50ada695f3baa48da3d8,python,56,44,12,14
NB_8feabf4670ddbbc77f85d709eb4b35533eb8867d62897888202fc7909fd00369,python,54,17,37,304
NB_d52edaf5491e442fb32edd9ae031a6ad2676324fdc08a06c602a665a527e05b3,python,2,1,1,90
NB_88d37504cb37ef5f39e0cdeddf52d91caa52959306a92ce88e5a62cab20f92be,python,58,39,19,36
NB_937d87708c9be4954f45983ede5d1ff4428e204d1a1ffccf379c8a5aed7c6a54,python,69,56,13,36
NB_3d53906bdb2121cc04bb7e68722ab397bbd52b71f7da3257fe4579bf09678781,python,14,9,5,5
NB_4c7ea4ba26d4401199a71a7bb0a40a508c2b246e86b97f3c5dde428c5dbd3876,python,43,25,18,32
NB_70f086c9c42845e657405ad51cb0efc90a42813c28a94ca840ee60bf37c5cc57,python,108,57,51,138
NB_9a595415d9f1ca10c72e268ef4950962c91ac5d3d5b3d5f771134a1ed1c71489,python,41,31,10,57
NB_97491934c79844b563f30954397b0be27ab191fcb406af2035d38a83ac747357,others,94,55,39,44
NB_131540861bd84dc94e6c8ebaed6f2a41bc1931bf41370947d0ae73cd4815d610,python,45,44,1,1
NB_976d4aa8e4678f4eb35e857939b4ed898b2cf1c6d8b4e3fca38d2a6e0ad37c1b,python,32,26,6,6
NB_4f4faf1f901aa1265495f2c7e57be19b4ed0f29162f8522c0bbd6278b827c1a0,others,0,0,0,0
NB_666a200ca29c837e2f6b6e0d852af01d9b77959ad24202f131c707073ec97e65,python,34,27,7,7
NB_27713ef62584b75980865105cbff61b5da8d6fce880aaf8c93e5935d301f0c09,python,13,13,0,0
NB_b93e7ce50971b93e9939faa9c88face35f55c9180ab25d4a9e81092251e7cd7e,others,26,1,25,151
NB_0173c52ec5b1e465240178215773cab5ceee429f2d2036b44d9400b84991c213,python,9,9,0,0
NB_d5f682da57d985cd2dbb5ccf073b79952fc974534f7f1ed01eda9684e08cf185,python,72,65,7,12
NB_7083b6fdf690dd9bbc3462d342cc7439c326a6e742abca74260874be4cba3a93,python,8,7,1,5
NB_b702c464acf14a866a853651b41307b0c64a919a661db5e550a907a32da4e224,python,16,9,7,13
NB_b3d0e083860b600847f55f9a3c8944976a4a64ab916355ae1810e189507a81f7,others,33,17,16,53
NB_e20ed6927a6f4df9ce3181fdd5aead90dff8817fd97d5637cb10861a5c8fe228,python,112,90,22,93
NB_744401fe36de65f0e77e250e8630a7993f475a1437113bc591283c06ff2307de,python,47,21,26,47
NB_486eb2e1a4289d97600efec877d405167e21ab683410acce200cb008dab7e423,python,44,26,18,184
NB_47d92b7b457e22392b0d1c978af12fc6cbdbd41d4c555f7c2071551449a2d274,python,81,48,33,33
NB_1b38cb15410e16029a361f069ba4e7cc8de1be2c3c76bd3e28aaf4c7fd6f46a9,python,7,7,0,0
NB_a193e4901d068f8a4223eedc522db6ebabebd0366684eaa3361a49c45604d040,python,28,15,13,25
NB_1e1148c5d456213d2d55cca52e04ecc6d915b54e4d336e88faab45b1efc0fd69,python,31,20,11,11
NB_691378cf593ecd468b71798f051c1366de58c5ecbeccb5fb2c4c34abdd932358,python,44,17,27,430
NB_a3a7cc78a5b79bc12a5d9f0e4af3859df32b4d094e1252a00127d01932f5b4e8,python,87,37,50,252
NB_1781193f02191a1629d2befe793c5a8185c5292fd51686c824ec0c4455e1f7a5,python,47,36,11,19
NB_26afa836112ec7e27430a35dff07f509ee0af21fec05024368b3a985a5997f8b,python,9,9,0,0
NB_e4c06ccc6b45aaff2a424abbe5f954f9db79e6722d568064b6b32462d180e605,python,7,4,3,3
NB_5015ad119b4bc422b788aa7c20b69ba618ecad8ed28d1d2572c62ee4e5696ea2,python,57,29,28,83
NB_db57de758be3a10907202edcb9927b08dedbc6948c34001862a39e928561058a,python,3,3,0,0
NB_223487889996d6cf59cd742f99d303da80dcf812bc4e99b2df1c3a523d82c791,python,20,10,10,11314
NB_91ab1ff418fbfbe69b709a40eb10a96bcada9ef62483813a33886ce7791210a0,python,2,1,1,9
NB_fbcf9444ad6f529502674aee25c00c19b663d7d5051306db06616f3596a9164b,python,13,13,0,0
NB_72811e34a590474c82dd85d60b7f34d48dea2fa5b8d73165d4c8b1ef082b50f8,python,6,6,0,0
NB_8c31fbc70855940cd3c62d5c58d3947d7a32ea2f510955f3b5c689ba711b86bc,python,13,12,1,3
NB_324ed0a07aaa79ec8acd7aad8d3411a350ee4a66a672c7bd721c5daeacaa529e,python,1,1,0,0
NB_1b150ce9052d401a56ddee1fa2c4c16948e5452663d1da9cb4df3f049649fe26,python,58,32,26,86
NB_cd65d7e1efeb7da408f994fb9a5fad1f1a91321a15e6b346c9c64a5fd3305bd3,others,36,31,5,5
NB_ee61c5e94796cfa923b314dc3d2951fa4fa1c18f677be7f6447b884b222817cf,python,2,2,0,0
NB_1043b469afe30bab4d8472fba68e54f64c672c35aadcb7e383ed309d4dcdf6d7,python,10,10,0,0
NB_bd83bc2d6e6f47e007c53437c7ac036a2ed16dfd1a8aee1c4c73fe4e66c53e14,python,6,6,0,0
NB_57391b9ff3b61a5deb7e64ba528dfaa0bdad5cb58e851a0541b277c336da7dba,python,28,21,7,7
NB_eac81a61e9ec5f30d563da1267cce5bc77d7b5b5dee9140dddc3f901a2ff54f2,python,14,8,6,19
NB_7a05c455874dc96f1f7e6ce51de17daed787a77b7039be2bb537e211123352bd,R,10,5,5,8
NB_8b8a0e36dd53390942858553e019af4a75f60e9770e4e165244368d4fbb428dc,python,39,29,10,23
NB_867504a48f6ab8b83c04883116087f6fe467c4475f9d0167e33b593e7b0c9932,others,24,20,4,4
NB_196126b543073d86bae72f55c1c09bdb9511ae4a6a1b61a82ecc7ecf381ee3fa,python,3,3,0,0
NB_0574d5ad64f6e8e152d68cd109cfc539be0f65faaf9e518eeed2468ae7f02eb7,python,44,44,0,0
NB_d970e97f962efe2c960cb3ce83bb6270f6c4447575a8697abf8775a8fabb6bab,python,17,8,9,12
NB_36dd86d788c92695ae3f31c333ed1bc8fcf54028ad7705bad545fae7945f4a80,python,62,43,19,65
NB_44c96e4af99cee2d7828977dbf9f7d692f4c8cbcf7a0db584309789d4c96305e,python,11,11,0,0
NB_b20134835127f2ee089b12cc175cde5352d6b9585d001b4c4f975a465dc57bfe,python,14,8,6,98
NB_60d1971b6a45a449b84e2ec0ecbae69c39ee72a0029e7b063c312d65379a67ed,python,45,42,3,3
NB_07ad98a5ff0ad78898e0b3098d59729a60afa68c339923f0ea3c9903d4abc8b6,python,5,5,0,0
NB_fe5d3ed950bd44a9b783ecd25a1733b61d60214a4095a900ee1379628e97f134,python,42,25,17,35
NB_e1c8e94ff7e6f1fba63db7be446d8cf80d621362f9eb0b17dc7b168fba1cd3bc,python,43,17,26,230
NB_3121a78f2ec197f336c03fd762b7057c793545f66a0bda21159fc06ee694cb4d,python,39,12,27,75
NB_6d51bf89f90253832cb56d4ee5f8fd03fb91b44d178b60031b4cf48ac34370da,python,143,114,29,29
NB_0cfe62e06ea1b0c24547cb4a0c6f7399367841599f0fdc88adc76f637cf38dd3,python,3,1,2,19
NB_620cc6b9aae981319f16ca95954b44925000be8dd1d8cf30762be112a50444e9,python,191,155,36,36
NB_a3934cf6f4423a2a4f3b3e0eb63f36cfb461b27475318a29be8ddbb8c047e251,python,41,41,0,0
NB_f272d321215bb31715d8c6a70f61aac682588eb7378de5e7ec58aacd5680f697,python,3,1,2,57
NB_64097ca12a5fd6173c04668cbf6203d5165aec401106a8362f2cc8e22d8b0a68,python,68,29,39,417
NB_7140cc2719e9aead10803587f533156fdfa210a7dea5c30b66fa6c30ca7e581b,python,13,13,0,0
NB_16d441c1633228b44978a372c47eb766f29d69e10924a05ac92ec92e8371bd38,python,25,25,0,0
NB_4e5caf5a6583e798b351c756c13c115bf947e27440115b8904108154f9c937d4,python,25,25,0,0
NB_ae27d3a20f5e6aa0957c5ef1de92cb9508a024e048f18b4f06fccbcbd1795059,others,6,6,0,0
NB_c46ba39f2498c20a104536b63364d6de081cd04d1d208bc098fe9fcce789f7dc,python,11,11,0,0
NB_bb6b9861b7bbbef11927bbeac74c2b9ca21d6ae2f110f837cb3640cb4eebbd29,python,25,25,0,0
NB_accb5bfcafd8569e89f82896df7703c4e01b7bc5bae9d17d2ae7a75960ffa4e9,python,8,2,6,6
NB_acf9ef314d8fde77a4a941d3989a6b364c0b3e1551e58c3f8481c54e1686cefb,python,8,8,0,0
NB_b8e844c43c28f3daea4fabe836e5fa4332726d406f6a7bb5d5c547b0c01f9d36,python,3,2,1,1
NB_a7ceb402f727b698e8ea1ae2d408bd4746c6344c39572fe67060e4360aec6c58,others,0,0,0,0
NB_964a2f91e68586d7a74a00d609e0eb29ffcefb14405399709aef77fcce977f44,python,9,3,6,23
NB_ce176c93c2dadb9b89322a89cec92f95696e16c96c2194190fbea57de12cbd3c,python,194,70,124,174
NB_550adbac8aa9687831a6ca477383dbeceb4fbc3d7ede8203792232101b9a1862,python,61,30,31,54
NB_5dabf8486b5be9fbb068188ae313e1b820db37c986cc3806ce34d5f9c2e0fe4f,python,33,21,12,71
NB_045e829272dbfd283850c0c83ff320398d1612c2d125bb946e0a3dab1c65cf7d,python,69,17,52,1080
NB_d0a18e17ecf996014dd32c0f79ca9c45c2b9db37b029e570a5e3784c2c81b641,others,39,21,18,18
NB_d98607b4a6cefcf97fa7343a93cece672264dd7563a5170d6dc14978e398cda1,python,3,2,1,5
NB_7b009dbffb320c43606816503549ab05852c59221e39115cae96e2e91699b8c7,python,56,23,33,208
NB_6e2115cb70fed19c1cd09130cc685a7afd8e51bf7032ddfd4e0e61a5622bbe0c,python,83,61,22,22
NB_038c52b7cbd8ba9272ba3832de4de7482a71535eaf69aa4be9da84421e3838d9,others,0,0,0,0
NB_6df8c6fe9db1f858cf7a3e5e58be93eec2918c1ea3e2a1dfac9d11cd52998c4b,others,55,25,30,171
NB_0481c2b27cc9ea8985b4b76e5354f08ef58e486b072754633fac260744cf8e41,others,0,0,0,0
NB_571d4527ce9fefbcb19fe5b980052b610038838b0ec1c29705934e175644c0f5,python,11,10,1,21
NB_57dbcf1bb41c51b015a77ddb5462131ced10e7db77b10e4876700311af91b8df,python,11,4,7,61
NB_0397b26bf306b5c45340b50980fa479d8c345bc89d43b4b4437175396cdf583d,others,15,14,1,1
NB_c0a75dad6e4a5e4e61467ee9cd6408d3a4261bb2ab637ac4d3c0f7b40cd975fd,python,9,9,0,0
NB_f9d4bd95c5e32e9d809f270b0fbd92c5feab535ac98812ec7f17f628ca96367e,python,11,7,4,4
NB_9379cc0e82dea0828e83025dda8c05db3b116bb2eea5087b679363f40177bf41,python,34,21,13,85
NB_3635a90d9e0bf46960a335b49757335f40c587583f5bafff2caa8b26bb4d05b9,python,41,41,0,0
NB_60b4aadae8a6d22b4ae03a3e1639835b109f00d357d6f612966c1967b507abb5,others,38,34,4,15
NB_ad2d3714879ed0e2929481845c9761235aabdf07d63a5300700924077c975f0b,python,38,33,5,5
NB_b0e51c3252d5e4b09ba7a0a9dae357b9c5bfc353370c910a237cda91e89e0b36,python,30,30,0,0
NB_80d9fa6489574e54e0f64752083cbba452e48504aa220ffce6ca6774c865eaea,python,38,33,5,7
NB_c0e9bec1d717fa45b4cf2b5cfde3fb211c662579d10e1cad752532a571f17007,others,19,19,0,0
NB_c627ec3be1fae10ad4bb3493ed99f59c20d7728de63622a4d5532f6a5590c1d2,python,23,13,10,96
NB_73cf2885ccb3175b4ffb7e68b3fa03f70a6197da2025fa217d441402ad3b234f,python,38,18,20,168
NB_1962394ec178fb06970e9d5bb50ebbc982964589ad57713708f3ed7adeb227f6,python,19,8,11,81
NB_4360966063736cf64f27d4fdfdb27527b8b1c753676572a4a81e8303b5fb7991,python,10,10,0,0
NB_abe011418db249ac1276410fdbde16cd73c3277e898e0096d54a1ea69b11caff,others,55,45,10,10
NB_4634064920209cc15c47bc0f1be911d16d75067b7b41994726f025dab5fda014,python,40,34,6,34
NB_7a0969fa2f37a9ed8489cb6f3a0a491fb00e8857423f7eddec62ca4376da6dad,python,39,24,15,21
NB_cb2ec1c0926154abf5d4f9c0064a9c259b2dfd021f2062c34f6433a6fcbca57a,python,19,19,0,0
NB_d104e851b58408c1310924eafe1139d0726f13fd14f3c5fa4539e571d3c3e8ba,python,54,14,40,290
NB_bcda925072b14d736fdab9c47076433c05509ec115d2d2381a0f914262ca2216,python,11,9,2,7
NB_ff9beb6d92f567ac07ea27aebaf7d881ff2a603be6408e49dfefc055775bfdcf,python,49,49,0,0
NB_36d0433dcd374d8d5226d02df93f5da51089396083ea40cc0e83f34a611caad4,python,64,45,19,19
NB_048b847ae85e66d7556c37852024057ba9f375299a75e5da2d5617944867bd7a,python,50,41,9,25
NB_da806f97b8cbd349680d6d906e459180193e56f2a7a4d58d7da67318e21ceebb,others,8,6,2,2
NB_fa3cff9ebd0f4979b6a618a47c79f49dba33b206aa7534ea659da14b47a9d220,python,12,10,2,19
NB_86a322d7d8fc9134d4d90c8ef4291e51739a7799b812d4472d9b31c2ff8219f3,python,2,2,0,0
NB_ea65a6bd3797042b4a75de64d4a14e4754397785ab76a678feeb2a759ac6b31d,python,19,8,11,114
NB_096fa2b897315a94227edead4e1bbf3b266e2b7777f240f46d315b61cc829427,python,29,21,8,8
NB_9a3d18c624cfcd497fa739e4d5823fde7a397908d09249a179da6720c0a438fa,python,7,4,3,3
NB_e6d64b84d4666ba640c0e47a85a9b1f20c6764d92da4f0fee6081655157a1c24,python,29,20,9,9
NB_3eefdc7b599548e9efb0f6f4b58d7712c9900614270e69010402583e1461029d,python,23,12,11,101
NB_7382955eff96be147c629cd748ab815690bea08cf0068aa06ebdfca151a07a31,python,25,14,11,13
NB_2306d039659de7482dd1045daf31f3a14e78d17b4d0824ac263decb9c90b1736,python,33,33,0,0
NB_8ab58e6df2110d7ecd5c4b27abbcb2344402db8aa0d0eac1029538146b2d073b,python,39,24,15,117
NB_860ebd04ab3dd26e129661930916a335e446356f79af191584ec04c3d6363cac,python,188,158,30,30
NB_2ac47733d53955f39dec6fe19295b1d100f39cc29f7f4d4460db2f58d6b12b88,others,49,47,2,4
NB_56288c4b4f7912df1780c0cca50df2f950452515935ba31914f001d1cbec70b0,others,78,45,33,37
NB_3f08b4fdfafc44a2895ac29d13f021b7938cb0c9c33213f8e766ecac511eddf0,python,20,20,0,0
NB_c503058dd468eab2639897b39e1d256d5ff2407f087cfae1aa477b115cd11d92,python,7,7,0,0
NB_41fd8f75d3804fc18529a5234569b16b4e131f1a7dd8bd7c378b61d00a2cbca1,others,15,4,11,80
NB_70bbfb6d71444988cc30bd9ebc87f00cf649c2ab7ddd3a7bf5e71d9d83fb1afa,python,6,6,0,0
NB_57d48a85af8954a448246faf6768c474affe9b4919340cd13d52ce1989126be4,python,28,28,0,0
NB_190b6237726ffd82cb0f064585bb967996361ff07fe7727aa21e8a4d6646ba56,python,7,4,3,25
NB_5567b85c77c73f9ab264bab610d32e2bd729f28db35b348657c358f24b3c4f0b,python,3,3,0,0
NB_a7ef45eca9e57f155224eb484adbf85199fb6301cd12697991d77e8062b67cd7,python,25,13,12,39
NB_c286bbd95e85bdf7fc363f3fc23c335074673e0efc436b731e6f814a8b40db47,others,0,0,0,0
NB_c5cfba5b9cbf72f2372cb40e3b39b83ac0a593b287f09cd48638a089f3c05c04,python,23,23,0,0
NB_1dee96b650596768f76c6dc263f019b98cb61fda9b360b20eaed47bb407593a1,python,69,45,24,82
NB_23a7c734851f84bb17a7789fa0ff8018ae76a529a3e8fd566200ad6274df5a13,python,38,36,2,51
NB_4d6966fb6d9a54686c8ff47fb1f5686cf7d43b98631f30481a08e30d2f1d4fff,python,96,80,16,24
NB_6f84eb17c59766b3884def63e4e8c424777221e41e03ac4f0565af420afe6268,others,94,55,39,44
NB_262ac575950062673e6e090f212e2ea5ac8d17eb6c4d87dd51530e8108d9431a,python,1,1,0,0
NB_ea52516d54f623361f1253e4208f2f12c33abd07787c2b96abf43d051df214c1,python,26,12,14,243
NB_2b9b2cb349f77ce39afd4d9a6730399225cb84f2155c8afc90b6f1ae26e7aa4f,python,11,8,3,3
NB_fbe124a8cbca9c60fae73db94ae598550926f8c5263543c2688bf28174909f90,python,41,37,4,4
NB_4e757f0315c0f7ee2b50990d5f739812e1df35da43708a91a2a20d5b411c7d28,python,32,28,4,5
NB_613e57db20ec70911b06eb697f0a6a808acb5179dd2010d0881c872c44054588,python,4,2,2,8
NB_d47128421ea18f4f583405ca1a7a3e2d44ba99144526e4e3b3b72117cdbc174a,python,10,6,4,9
NB_52b2309aaf388281647b873c9afc12f2dd46c98d468a762a97e7c1dd79a011e3,python,32,32,0,0
NB_74a6404fd7e8c7af5d11c89a1f1d2c794fcc1797be753e2509d84bbd2cbcd0d4,python,2,2,0,0
NB_dd7ccf48192f567cee71851d88923ab1adfba424799313102b467b5d05f3aac8,python,27,15,12,33
NB_5a64eeda0872feedd23c12088eb5888a32d375c6a8ee57d28d32fa91321a8c6c,others,31,28,3,3
NB_5bb3b745f950181468570ba3c683318a05e2c0f7cdde79b11aa816874a79f40c,python,9,9,0,0
NB_8c9cc7a02d2b3864fd6255133ecde4faca8d1350ad0c3040d0b6f2a426568a81,python,34,34,0,0
NB_fbcc93a8201bfae6d915a6a5c9e4fbf67b9bc6d499e4ad81b9d3ef0152ad6187,others,94,55,39,44
NB_c9bb3ff2d937b06e60dff71d1704f110e22c2034c1c9ac0b7505ad7659148552,python,16,15,1,1
NB_cc8e1421d0955273f94b255762707bbb364f9e0410d540982fb518f4441116d5,python,31,19,12,40
NB_ef4ea86a564b6bd867781119e987c845aca71ba5b5c77d4c98e898133fc738d5,python,51,39,12,18
NB_b7784eaba71b21828ba16e6e49ae17092f01873ee4eef48e420fd54f3139ab77,python,2,2,0,0
NB_575d615361810895dde70f639c88c3cf843a980eca5e1cf49f275d8346dafb04,python,24,21,3,3
NB_cce344457546eee26a594789a24c20120f4621f260c0c6cbe4bd15c83c3fe412,python,43,43,0,0
NB_a5c979989df9d5424c3d19354f0db652cb789f85fbc9c7a8f79868af74b850ed,python,43,18,25,151
NB_0c48fbc8bcc89beb7d834029390c39782372b7aa6457468df0952e37abc5f07b,python,25,6,19,144
NB_b0f4f4e2b865e27599e68f154f600dfb22ecc55ef07df52b8aa45e40af3762ae,python,12,5,7,145
NB_d16e28c7b232c81171662d311b94ffa2bc158635da851293efb0015300efd5f8,python,51,43,8,180
NB_694e502bfd0795844f97905242e46516ca786b51c4edb2545ee8b8e2941af224,python,6,3,3,31
NB_277758fa1ab73c4bc203d4050ebbe295e967f021d38e18f8b38d2bc7a8619747,python,19,9,10,52
NB_f4a2c5cd821e4d2979d5571b5f06a5874a4aa446cc86c3b9ac73b56aa58fe867,others,53,35,18,51
NB_2088ca79d261ba3bac7ed60ea3c6555d9ffc0e8beea9622bea7d934f67233e5a,python,5,2,3,69
NB_42fe618bcb5047496c87c39a6c612c1a502c0d3eddad7b0cc37416bce62602a1,python,73,72,1,20
NB_36fc86b4086d477c7974990cb5020f78320fbf58155776bcc0990383d8df1575,python,12,12,0,0
NB_5e44fec0b35894522d1f558dc98ab31959415de349b4c307c61699c6ac9d82d2,python,44,22,22,143
NB_d4dceada5f52f6631cc20120c4fe5382895c857adaced324a2217769f7c30f09,python,356,226,130,10298
NB_62f8822aaa5c361bee48808a1b79bf044e196334dd5a89f9527320711ca7d799,python,59,53,6,6
NB_2f5a98c655837cf5c5b129cb8e9b58c87feee2d0d30318e93a9734608b91df15,python,11,4,7,61
NB_2db70d52da41731780dc4702c3ca8df655eddc08eb190dccd4351cb9cd52d65b,python,53,41,12,19
NB_14b30090f828624353a23e6179c03aba54cc4d75626bfd446e3108ba65373304,others,34,22,12,18
NB_ca023130a4bc168848c7fd0e8d65f57590b9bdcab0627f494ba85f8ae2f85d77,python,3,2,1,13
NB_34169edfe86487d61fcfff17f5a37899d75ac4365eae3e306e6b90b01391ff5e,others,25,13,12,51
NB_3d4aad546590af24a1d647fc36bbf82d126d04c1691937e24ea1d5533533cd89,python,8,8,0,0
NB_7989bb91df20d6d948e69d3cbea0440a07875e0301ab232225450b4273ab7842,others,35,26,9,9
NB_c776d665f9e579d398dcfb8642edc7a5958a60d862ddd4bdd3c697140638720e,python,34,34,0,0
NB_b4e7f28b8979dd0c1d9306cb5fd8e4d466a62c54cf2d2887fccd17b48768281f,python,5,3,2,2
NB_7ad0d35fc4e488084e0ab95af14988aa0fcdc97a0935807367f7c574d480a00c,python,17,2,15,682
NB_9c8f3b5873b947268fee3c043f0e1cff0809a3c02e921b3c347a4e0a5f6dc1c8,python,7,6,1,1
NB_659109dcaff7da277f2ba887a10e09c9948de36a5114306fd57d113675c76d20,python,28,27,1,1
NB_2c40ee5ab7d2bd5925da5c4b08a216f18dd69fecb6a1069eb34f5a5dcc410e8b,python,53,53,0,0
NB_f176fe8b6f3b743e2139af9a90920d9709e07909f0ab2fde2f10a0265b4a0442,python,14,14,0,0
NB_872914c248362ed8f21151bd537473eaf4a6e77fa272f57672e8ab417505c6bb,python,13,3,10,152
NB_88206d21301030d11834424a07f6d29d3bcc801d88dd3914cf7eb972270a6bdb,python,81,66,15,26
NB_d5cf6dca501821946865a11effe3779499f30a30e373a43a4e5983e48a5f1c8e,python,27,12,15,235
NB_a072cae9b845a62ac90036d72ba6623ff4838f0c54b6affe7057184931001952,python,12,9,3,3
NB_f70be376db581af5ce3b6a645d06c09de2a989ea1ef704ea5b651ff3f32a794c,python,17,17,0,0
NB_bb1dde029cd69f305b48e1abbfd43590d8d4ae2ddd74272452ae64da5635cd09,python,19,10,9,113
NB_e947a6889daffe4ed1aecbc4e221910a8332c1a4f64ea649209593b55e777d08,python,11,11,0,0
NB_80ad17bb01ad46a163b35e6800ea4358f18b047f94562a028994cc82741fd4b2,python,51,27,24,75
NB_a2c20dbd34313c4ddefe6f164a2fb54534e7312a83226d11c8cd677523f4980b,others,42,24,18,18
NB_a7005869f72bb736da559858549995c5f7c5ea7f1cd31e8ced86a8665ed84b1a,python,7,6,1,1
NB_bf12e4677fad567ca6e92f367826b2e4cd81b9d938bdbe0bbfd8fd6896dd1d3d,python,64,33,31,72
NB_263e070b91772665463a0b39f001d86b76af05ed150248fd43bc7fb45e418721,python,1,1,0,0
NB_794368b5ae5e940a1435bb47b67e13dc6b88079a65239386421cf3826f8c9bbc,python,96,57,39,267
NB_418b6397c310748088cf11689f0c4d09605d95c946bfbbd48df7bdf74d5a833e,python,16,16,0,0
NB_dec88db64ebd813c27348ea6ae9aeb8e990b758dfbb55d2a828b182c3293a13b,python,7,7,0,0
NB_bcb907f59d457a915f94696c1c5c08bfddd7417280e0f4478897ccc4263874a9,python,6,6,0,0
NB_bd9e349112bdf9ef07ffd9855f9f26815a8d560bec26e38c3a96abf9522e513c,python,5,5,0,0
NB_46cd66ccba0cf06683a9c0b4176921006d7480c1ef239cec763214f5fbf74039,others,43,21,22,62
NB_4e9214a9423c8baa6315d825a8f3d55eba11240ad5179da00fc2c72214221ee1,python,1,1,0,0
NB_dff27a493f9fa35ab458a2c96ea1e73bdf53aed2d4ea5ea1bfc5afd1b26669c4,python,8,8,0,0
NB_3afeb326b652d184dccaf675640a553d78ea72624a0280dfe7e03719836a14ab,python,5,5,0,0
NB_f0486bb1b99f5838670684c1ad856cf22ed7194e1eb24428cd8998cf1a2c4ecf,others,41,30,11,15
NB_5ee56143135c9c04e2c1361e5590335ddd4374d1dd2a9fcef5935b3fd11b5d26,python,63,31,32,31
NB_b76eee1707fd202c8076f76bca59c83786736ef50cd1727196476b35ea971df5,python,12,11,1,1
NB_63a4d773c1c196c3353b2cd68f622c7f33707b3664178d15ccd4fe2d3ae7274c,others,102,96,6,7
NB_ca6eda1bf9c2e8d890084f5351eb9a27ef257210bf9e62b8f171d3fc4d38320a,python,31,19,12,37
NB_97f1d7f578616366684f3091e7203a6dab29d0de98f5c7376c89a50df293ec99,python,32,20,12,56
NB_078898d2420d7e3f2041e49e8b7b6f48150a5e29a90e1beefcc3a17f35526675,python,31,28,3,3
NB_fec84ae1c799147a2002e58347055750b2adc646e31ae265eb14791ec73f3660,python,14,6,8,10
NB_10f2adc15c5d28031962a3de1952a1db4543fc1756d44835b17c75596758309f,python,33,16,17,41
NB_00a0e2f009613d9010772adffff1bce77dc9d6c332f006bc72cdffc2605c20ce,python,27,13,14,59
NB_9ea136d3c4025ced0ff668d35243a97ecfe14098e6e9acfe30d709bed32021a4,python,65,33,32,145
NB_9f66a845b6b6861745d9eb3a5330e7c4f25667693db2df0616dd384062ce292d,python,22,13,9,22
NB_baee31ccc21b1e709203bc1df4d6053c818e0a259b4b7f6c439715213e2e4f9e,python,22,9,13,13
NB_c4081208be4024f3ae93b3af13fa5883430dc170f2920f03fee4b912cf89773d,others,27,21,6,13
NB_8669d0a060924b1da4429749a339fba76cb7dbb77d65934f5586e50866489dfa,python,10,6,4,4
NB_7b10ceb3c9e1e5a97154ae8b16b88da604049fec944bffaa0051534b5322ea04,R,63,63,0,0
NB_d09191eca9811f1e1cd1122c3e6e2a0f4c00dcac52058a6e802392a1a3ffba6c,python,12,7,5,5
NB_e143b7a0ce41f1af7fd4768fb2cdf9e3057e8c0d65e57bd495111b35c326d148,python,82,40,42,230
NB_a39e6506e2a681c5f5e3c8b1d3f9a9e9d43934196c4bd396bacc0a7f49341662,python,20,9,11,151
NB_0e1491979af318a4a622a9afa7b3dcad546165ca41eccd8395090afcbd870b5a,python,45,21,24,439
NB_6e0be5d71ef2cd2c231b698e04cc7bbbc3b78bc758cb4017704ecdb8c7f459aa,python,42,17,25,130
NB_e080a8e3281627500abb1c4756a0fb9d476220071c25381ef03c5f0a46633b5a,python,17,11,6,37
NB_db92b85fe37f9d92dea97a2851c717ac192e62173e2e8ab9b60f03cd7d33f626,python,19,14,5,5
NB_ea42e7ad1b64941de2a3ac852f8f56185a133dd6903d281c08d5601006a2dab0,python,51,28,23,242
NB_c326a277c5bb8c65ca7e075a28922ea5ccc754af9c829ff290ce7ad1261ea8d5,python,14,13,1,1
NB_de27bb73d20056d2319b82d228634fdfe2da0cc0b31c08e369cc862e53bd3a8a,python,180,141,39,39
NB_d52c29e5b0d81a02efd2ff8870f88b6ed48524a69d5ee9aa6c6fee5fdcafcfd3,python,19,7,12,41
NB_873bcc15ddb44b38c6e754ab08539ca17a0a579ab5e73d688e91ced2e4ba8725,python,22,13,9,111
NB_5ca15519674755646063efa0160e4e9c18faaed293b7ecadc352f63e919b1b64,python,47,26,21,272
NB_4b36c16aca6afc90039f291bbcc0ce899d74a5b8f2b8a1214545ece41bd03994,python,11,9,2,3
NB_3c69a99ebda894c433776fa7c234dba236e8dc18c746bf986423bc480ac765f6,others,22,22,0,0
NB_2e4b0a68e9b0c236d433ebe1c50c0a62fb6db1850f92b5e4db32fa9acde394d7,python,27,14,13,122
NB_b30002f2cff4427e0b3cbfe3a41aa5fea5d91d67315c3fe9ae70c063e3e51ace,python,32,24,8,8
NB_adf87ab558021ebd594aad7b40d6e1e8d924afdfa46513d5dcfcedfc5c7a1ae1,python,13,9,4,25
NB_f04a8ef32c3fedb7ff7af4bd17d07f1f16548be6ae81abb73cc51a231766a2d1,python,10,7,3,7
NB_43d765b9192936a0bef6cbded67b7ba55b09f5cfbbda85d07e7e3bb2f236e220,python,34,18,16,140
NB_84721509af459624f3868aa238def4e1af0aee802ac5a234839e1b0d7b68e8ba,python,102,82,20,171
NB_8b592e44d2696198151b595836fb3d5ad49b0abc059dee41d7aff4bed35f554c,python,34,27,7,7
NB_5c1fbd5b364652b71bc445d61323f1fbd629b5bc8e36c4f6d4b874d6f7225f4d,python,5,5,0,0
NB_362347f0b77da1581c69ba5330f4b5eaa25e7b4c504d9b7e97814147e8d75245,python,41,15,26,46
NB_b2e30c442843a09b93c09fde21263ffcf5d45e86560a37d2770e0cb489303e86,python,34,20,14,24
NB_fd03d6b680b0187ce13758f18a5b9aa71f50eaaad799e5abdcb644723019298a,python,41,36,5,5
NB_cfa67a6d56fa0c14e0cdbb1e4d7a14bbccc0a52bca2cb408f416e9136706b910,python,11,0,11,213
NB_1dd27b343fa72b88351134853b07e89d5acb317897da78d647959263bb4c8cd8,python,88,52,36,71
NB_a87fa7610a1d7d80b6f16f6ef4acad06fe072919887a016783408197e09f3701,python,5,4,1,2
NB_444aa98f4ab20ffb22329ca90cc0974bc7368c67cae70f354c6f609e82046846,python,44,17,27,954
NB_16e81b480e464b73a6cb13e663ee97c2ceb71bd6676cd0b57dbfe68ceba63791,others,47,31,16,52
NB_6eb07e5127befaeb3d26f333fd7c9a2d07c4b5443c9795dac172867d32d9f78b,others,16,10,6,9
NB_6d579fe0a8a49c411727dd306c7b7c745838ba9c1fb62350ee1cf38fdc15129c,python,41,20,21,224
NB_1731527e85021701f025ab09bc08a6785af5ba51332e6338d5257dfd7735f0d8,python,4,2,2,24
NB_04d887a6f32e5fcde2341a0590e244f3433dc50a7916b0ea3f7fbf2b0d2ddbca,python,15,14,1,1
NB_d940c98ccd814f386624e026c553000b07e6abf54b96f697b67cf3656c41d18a,python,136,120,16,16
NB_d95f82178596af6751ce826ed13becf46e7582946bc5ab98dff071208c9d5d2e,python,19,5,14,61
NB_8034a7041f5adaf48144a11a3f0ee428c01dc64a597e73a4c2420787e79fe76a,python,22,19,3,3
NB_52fa0eeb33661dfdcc90a879c7644df86a2411c2d640f0c22f6092eeae9487f7,python,14,12,2,2
NB_8525d54286c8aa8bdd5810b52c2a2e0965641770577eead200301bf5f93319d7,python,29,11,18,90
NB_b6e2c93c481f04c67e6a0c34f0dce890f6bba57b4589d2357fd07bba30a0e068,python,12,7,5,5
NB_588d67cb595a6e36d389833a8be5de22021b14b3eef597202721f4b3d4913ecb,python,16,8,8,16
NB_ad3a5f4f49cf76c6818203ffbd67d5d9937edbf9a79595f344c77e5f5fa4eae9,python,42,17,25,183
NB_ce5e9f0c4ef94aa4317034edb7850c3cc2eb5f4aefc3c77027ff98b8cf138411,python,15,14,1,1
NB_d3ca2d301ab0366b1b1e295bc4913c15e997693510af24f36edd6b7b35c9ec2a,others,54,43,11,22
NB_4630d6d3957617634b72021e323fb3e3aa556d9600390f6c88d4ac467e01ad0d,python,4,4,0,0
NB_108101d9f34637985d611ba93064dd3cc266355bcfea1c774d2a3fd4fd5f77f8,python,308,161,147,208
NB_add265ab252f86a30e52ad52fb96b9893bdc4a75985e10672707ea848b59e995,python,9,7,2,4
NB_da4547dbd91ba78b0b081bba05deb1c56c73c90cb8e15dff5ec0fce5849efdd8,python,8,5,3,3
NB_a7f5cdd8761d492c2b97947da2fb1e40b8c8783b2890995617311b5930406dfa,python,4,3,1,3
NB_b051ccf2d88039a229f56a5e978411a2351e4a9bfecf43001419245e317ecd9a,python,31,24,7,10
NB_23e1cd68895f28d7da371a069618cf24c618335b495502b032461649d5859de9,python,23,16,7,8
NB_155aeedd437e6643216c9d30162463d5e1d5db57ac29fb0cb4e822f7577dea5d,python,21,9,12,40
NB_8fe19b256b00b25cb807af0661e6b396722ed2e65a349feb0fa9ab8592750a91,python,452,338,114,121
NB_6c92aac2d4b1b02e09752b12c6ebcaffce6ad668bfde3b23bffd9d5373bc1ee7,python,13,13,0,0
NB_92831320d01efe65ebfd84e01c662fcec023cb334d1659abf29ecdba8ba000ec,python,34,18,16,141
NB_682ee0ed241ec5e6fba381216e8e00e6b5738f9a8b2e33c68c127d655d98e98d,python,60,44,16,16
NB_dd503d719dfab6b4f45725906b10282cb339483d1c6cae7fb05030b9375ca016,python,31,22,9,11
NB_e7f7d8cb34c9004120fb2bf43ac749f663d54def334835bf611cccba952b5f0d,python,82,61,21,21
NB_d3a599e26ce728547441b1cabc83da127ec3cae2e58a75ae6d98139bab00c290,python,14,14,0,0
NB_37348f2104b19756157c70d9fd2fd30d4fa654a7d3a3d0b579e4f3129b320d60,python,4,3,1,15
NB_d26ff2388b857a9da17b1861e373779e6f20190dab1ffe700e4a7b82e427a617,python,31,23,8,27
NB_5ec75d0150da75a35e3f522de24b181284fbdcfce4789b1bb095c595842ae0b5,python,9,9,0,0
NB_9662cadf686d6d2e30d478eac259187ae91811ffe6f1d74d8b6aff504ba7e152,python,18,11,7,9
NB_c3dc4c5f59af410da2958eb7f216a5ede2379f738464a4703376a335ef94cc63,python,15,12,3,3
NB_3597edc21dfc278b964cf3c80a41c86b70073819d1c374eb42ebadc144fe14d4,python,22,12,10,18
NB_1fcf138587e6ad9ce1f662818175994fa636ef2e3a4f9ebf648588ceb517f161,python,1,1,0,0
NB_c3a0c4959dcd28d2467fe305788bf2617f9cded2f2c7402b6876217cf34d4b95,python,2,2,0,0
NB_7d0a937d3b07e1da506bcc4cc355206701dfc9c8827bf630002645fe0dec2d9e,python,17,13,4,4
NB_d5a1911aa06dfce1831ba5d72855b8761b139194c6edbb9a03c0d36d2752ccd7,python,37,34,3,3
NB_4fedbbc780a4751d37c94fb42de7bc8115e09713f5a7d4f46e8bd31ac7a46534,others,62,41,21,25
NB_735796bbcf24d977b5a9afacfc365b2429d554c8d6eff19eb1408562b8935eb6,python,44,23,21,81
NB_0cb97f3f7d2900cf591c277fe3c427b7dadff45ef067381ac91b7e10e6288356,python,26,14,12,69
NB_c5fe0fbe372fb88465a4958a7f475cbddb469e611315ef52062e7ceb51cf2ed9,python,35,32,3,3
NB_fcf1e66273defec545d7d7f3338f11da69e111f6bb6f1dd122b8f4a3e6d6747d,python,13,8,5,26
NB_f41055c7cdeea3571c402d394acecb37ec55144ce17af99e50ee3ea2d214a554,python,31,25,6,6
NB_b471e1cbd577af114f1dd955120ae3d4a52d3d41635baa096c0b77631ee8d178,python,25,1,24,62
NB_c02e2f1cee000faa29be02aaf6de62701f3913525a8460e4ef989ec571da6598,python,6,6,0,0
NB_942f8408394091f8dc4dd25fd9b0eabcbe20e58acade0eeb0a1c67338b58409d,python,24,11,13,112
NB_e28d3689e1671e634e1333a9a4116b9656ceb7a82a56c8a9032dcc9450200f80,python,28,16,12,25
NB_fa24d89c928bea139ca1b99a669d0cf7c5d7a8e8cd82d6c43ebe19e52989219d,python,75,28,47,356
NB_f73d9a3e86d001f437e0402cbf1f8c7250615e8c6fe11a7abd2136a6189294ba,python,10,10,0,0
NB_e6d1f7f2761df72c204e5450fa68629b2e523b493ad0abf6b187ef7df711eecd,python,81,81,0,0
NB_88a4b6273adef92f835e00652ca19fa051657cfef2a4769e4d2180f13db44489,others,41,30,11,15
NB_e9527b8dd3fed093ef0fd98ee281823b1ec589db79d9a2c7231adc4e422e0517,python,13,13,0,0
NB_8b62f8de384d2c5eac76349e75bf3125fd9d3925acd7ceaa549db7865ee640aa,python,10,10,0,0
NB_7b2f23c62c7cf605ab8fd5ec4ed7661fcd8acc0feffc073d33eb793015f2c51f,python,28,14,14,14
NB_a83c29adb8ae492681c82ce9d27084189138415546913be4f892940a1b91bced,python,25,14,11,101
NB_0c9d10ebfaee81d39f0de4d6bdd36fc41489558637713fe06349b8b0894b0f89,python,6,6,0,0
NB_13140827e36c3ba339f5ad54ae43316f66a02da86beab921037ff7fa78f9c809,python,13,13,0,0
NB_8bd44a9e548eb24b422eb1b6df3182dacbe61750380879e164fbafee832a56b9,python,14,8,6,31
NB_9ab3e8ce5ee7c0b20ddb0027cb62797febae75d2b52bf8a77d42142a8cefc977,python,25,12,13,17
NB_544c56a9d6b8c1553c0210b54c600456a6a86319da8efb4d0fde0b0a0ecdfe02,python,65,26,39,436
NB_f7a22243cb0e9930a88a4536f6c862e4ed125309f24089f7bb087cdd4e47d281,python,12,8,4,4
NB_ea8745c698fc6587a84c68072d07dc12510bbf39a51f41a9f8a25810199908ef,python,54,50,4,47
NB_a67f9a17dc4c3130f83c84353b538e5bcff069db358d61c8875efd8ba09ec55b,python,53,53,0,0
NB_ddb879e6759e965b99d50b580f7a9ed7aa98957f92775e557568491e12aaa5fc,python,114,114,0,0
NB_3f27e401e29e6aa96629cc508e84055ebc0a4a3286de45a6a07b6e61cff2a5a7,python,2,1,1,19
NB_f015b4a4b600addd4e6a086e39db5c49e1243e749437c08b686db23905bddb8d,python,72,46,26,64
NB_b379396c064e1a86ec323f7a438f7c426aabaa3d4566379904c899af41d0707e,python,44,25,19,23
NB_6a3e8c99fa358d8358ab3bc06cee2924103331dc7e05fd683e56c5753fc8cab2,python,14,9,5,9
NB_5a566613b9dac05c39ef314fff9bac0804483727b3474fdc498c9dcc704bd594,python,7,7,0,0
NB_b2a1bdc3d6ac1516c889e84c24ee8117c7a1277b61a679ea993db11aaa480457,python,6,4,2,2
NB_3758227c3bb44fee81a334714894394510148f1be1831ca9a0791913339be332,others,51,29,22,23
NB_eabed6b2d5fe12e03decd4c03731ab5e81999049a5b0348c7a8a07a4aea4c561,others,0,0,0,0
NB_d6e9a8f5dd4426f16df08f461827e7401373086b759313d45f7d31eded012f53,python,44,35,9,9
NB_16d2e4ba8a1a625931ae693fb29e4ea203ade7b23f1dbcf3aaff6f13f36cd34f,python,14,14,0,0
NB_836bd1c8226703da3d634da7438244bb049bc8808de86664ef93ff6b576c6865,python,1,1,0,0
NB_b44e82f34fefe6f0392ddfd7066a4a77874ca24456d3040f93f9f13fd9027bbe,python,71,26,45,325
NB_9752d77c8342e254af88a4b38c435d0e4c2227528cc6220c381828cf66ff0adb,python,6,6,0,0
NB_753a3cb137cba1cb52f1c1443e333b8dba9d35d2414fe4f65f79d4461d1e9904,python,11,6,5,5
NB_0da260033e411c5e6abceba056234971fdc032f9a7e1444ebb04f4f2c6e26090,python,4,4,0,0
NB_1a6f4aae56707e60d56f08ff578f2e0f1fc68be1754133d6db3b1b4d213d246c,python,26,14,12,69
NB_eed8e9db9eaf4802cf1d6bb434eb7dc71c1f00e78f09cc2b85e7dab8147ef7af,python,25,25,0,0
NB_62c57129123552f4200d7446b47e9fb63e579214bc64334fa86f0201279bed67,python,47,45,2,2
NB_4bf3cfd66c43795ef178c569bd5e47171f851b5d1c9b4b5ae91b1dd2d8f5a192,python,10,6,4,24
NB_6de9583feaf0d7f84367f89ef84a14d592fdc0074f9b9b1236e6e0769403b055,R,36,26,10,12
NB_21aa6b17e2f1f33cdcf149d447e971d455829b4c05ea5f3352a607a9f96f6a28,python,11,9,2,2
NB_ef4e9bd5bed49efbacde11745f3cf01ddc97541ab93f254f3a0b55b789efd79b,python,28,28,0,0
NB_735158a47a7bb0dd19db51091a897de71dcabcd3f9e7c28939acc472a0a38beb,python,25,25,0,0
NB_af21f0b5aa471c092cd66cf5b412816a1668130c123b63fcf9e24752fb4bf1f8,python,56,16,40,309
NB_54487e38e891d9820bae91345b3c7d03962b6f83e8f4f9a43fdef906bb7a9576,python,47,18,29,32
NB_1d1b8755cf065ab8a7a5ee47e551ab2e378aea2f98fa358870e18e4c95d6d1cb,python,13,7,6,48
NB_b38cba6b000d90f9f61bde0ec4652c184a2b526aedaf91ef2210ca2126cb4048,python,14,14,0,0
NB_ae59b1a6a40c3a2db3f970ef2ab30d9f49d04ad923e4750ac76b3af2c8782ddc,python,84,46,38,51
NB_47f33550cb8c875a2a60a2261c3f6e482933cc546858a752c327d98d0a786f8c,python,24,16,8,127
NB_ddb9a9c2a3563a21719c6329ff13913fccc78c05b4cac023a198016c6dfb3402,python,44,22,22,58
NB_d05b6dc879e5a0b93c8c291ca9c6804c3cb82a9b57729483b53ec88aa93c1d73,python,60,30,30,110
NB_7a185e49089034acd8cf5d672995c6a15e8711c4d16c8313ddec8a2c46e4a67b,python,48,39,9,9
NB_281a8b7b655f64c03537c7adb5056694409f5d226618d28ae92618f4291d9bc0,others,359,252,107,537
NB_c6bc010a4936cdf705d943ad56eba4f437b7751025553586dab1cd81d9393f1f,python,34,26,8,13
NB_ca9f8081db059047966bae1e03b56c9e80c41f2201bc50d51c647e018a2833a9,python,22,4,18,65
NB_bacc21aaf69cc231904ee65781108a62d05441a1622eb5cdf0b516ae0f020c76,python,3,3,0,0
NB_0a6da8acee6f9d74b300b09f86023aee0cd27cf7e1f190327cff525739c45b8a,python,12,11,1,8
NB_b8e0bc9705ae909f1a90ca684ed96dda41ac359f5134a444371235bfc781c2ad,others,50,27,23,23
NB_37ea1c0b49289300c29ab76de6554f6f550c479cb625f99d6b4175d1c2340fa9,python,29,12,17,164
NB_2d567d0714885fb3286c3450d85c107fe67f2a157573d765a3b2c00a45d8ab47,python,18,18,0,0
NB_bf6425a89296f17db6e8c3998dd2a5e9a36753012cb5499791f2b8d6177e2c87,python,29,29,0,0
NB_b069f4e9fe8dbba7690311f6cb9b1ca3cc63b086358e86f492fbf18359e3b4f2,python,16,12,4,4
NB_f58e4f7e36ff719a9f8831a2689b2c02779d2c330dc56c944c0ab0227655939f,python,1,1,0,0
NB_cac3f2cc9493121f8fca7bc5ea7ab5aef595b28939819c261b73468088fb78f8,python,5,5,0,0
NB_9b771395770461a07d9031c1eeadcdaee18e5d8c61ee872478899844ca3f2675,python,25,19,6,6
NB_20a3a3dceaa5c891240eb510a80de4ac581d6f5794600ff5f0fee0b3a639f7af,python,14,8,6,14
NB_a8312427d78c165d7386044706f7a851c0eeabe0d1438b6a030d3af9159f0ecd,python,27,19,8,1696
NB_77a3e86ef68e965c86380491644fb70b120dbae40f5f23be3db4f70559ae32c8,python,95,87,8,8
NB_78abe5711fd4162004032a3b1b59e32ae9c78bc9fe562697731a1341b5bfa351,python,150,90,60,171
NB_2fbd355ccb8d8e45d6a20ba15025270630be705b8c6076756ae4a7739806a212,python,15,14,1,1
NB_b8cf6ae7f18e544a61c7179265929911fc15a1f8eac015588ea8ac5fa6f7e0c2,python,24,14,10,10
NB_3f0f651742f9005b88f74783cd8e9e365dcd2e38bc17b61488cbeed878fb6aa2,others,58,34,24,24
NB_5aa72d95823352e88034b7dfa5a16ce7caf33e1b819d979872261f0fc6789232,python,83,66,17,18
NB_6493cb2d74a92a4941f88928baef20c0bb951af71d034de0b8231868022e433f,python,16,15,1,1
NB_1a2b2e29fff37028d0862f64ade3af0bbecf2d559a634df7dbe7306a72450238,python,16,12,4,15
NB_307401a9a649008ee97a411a184b22c158ed72f09beb5afc0f110db65636a6d6,python,44,22,22,176
NB_7750afbe0dce5f2f97883f9220ea7eed150f5462b0b3bfdc69ee665b37430f2c,python,64,25,39,178
NB_01ebc235a1044d6ea614ce5f4ef6cec2e35f90f9d51523fa396d2805ad324517,python,30,21,9,9
NB_b8ef1e3f3bbe071e5d71dcff02891654f0ab3a2d70ed939919ec2064cc632f63,python,6,6,0,0
NB_fdca8065fd62de84728a59ece33ad98971891709bd67036743ed7beb1dcda907,python,20,12,8,16
NB_391034cafc2c037fcc82b05160abdbb443f2ea9db1280540ab620cf127eb952f,python,21,21,0,0
NB_39039a2e584f273582f967163133ead6e3a5d901fc5be1c432d92b50799b9b0d,python,24,22,2,23
NB_2459796962ec1df8f9164814fbb608049a749d5ca7431f372180d1c7ac6d0b32,python,6,6,0,0
NB_139e848e1928346c5040dcb8a82b59a8e441810568be779e3e2b1cf2d9e2522d,python,100,80,20,171
NB_59653750027213075da72056dc9f69ca985882824e06fefecbfb0817a00aea20,python,18,11,7,19
NB_27589e35ba5c0bde3ce520fed1ebd1c85cffaabf3b92b53e9e5de95bddc090f7,python,29,18,11,11
NB_f573b27f2f2c4162c252d4bc78aa866b3be0474e8c50ec3bdab792d100a76884,python,16,16,0,0
NB_1e09bf3bc9f16dd98bc2d69ae88b780e328c9efead6e983acb58e9184719a925,python,27,27,0,0
NB_cfc1cc98aabe9652b511abfb498506baf358f8060620d84f3ff3d36cdc630319,python,43,17,26,230
NB_3f9c54c4e69ae78bd7bb79fd63433e0848aa9d6e09c19c98d5d228c856ec5d27,python,2,2,0,0
NB_69787548865d4b48235e5a963034b650a950d720cd690086d88afa4302646426,python,29,21,8,8
NB_0255a407f52e66eabb7d65b85267a392107f6168910a653f5c0af1c351708a37,python,25,14,11,74
NB_c55687f7253c59a6a8932657b0925623b66cab833116b5a3c48bce0584c6e9c5,others,67,32,35,38
NB_4fef25f7588e6d8061e86ce52d2cd151d8e2249ab5984cfec628435930908152,python,22,18,4,6
NB_1ca85720fd64f06f044efcf46193e27d736cb3f5dbc5ed8c072f6901f2ee7a3c,python,52,37,15,18
NB_ee5c4d56242ad59f9fa4d623fe5bd734896134bee1b477af9c44fdd5a357d4c5,python,10,10,0,0
NB_b6fca2f456ddd8362bc53a0dca45abb5c8ca69b257ecf4c7c6c68c01d5001334,python,20,20,0,0
NB_1ba6cec9d55ecc9dffdbeaf4c58d7ab3d3132e72b7da33a57af26f85cfdde1e5,python,20,20,0,0
NB_5d9afc7cc741222713a91344b917d3d4cc9e76c0d66834ad754189d85c552524,others,78,45,33,37
NB_6f93d8cbab41003585716c2c6c3ed1896e2f9d7e7dfce5fe5c361866c688c4e7,python,8,8,0,0
NB_6d72fd882ce01a1281f62da6f1e6eb5bb9062aa08b7878d0bbde2a2a5a4c7464,python,26,26,0,0
NB_8460072398f8e77a5c3e0184269c64ab95bdcf471c754a08ec664c605002b5e2,python,27,27,0,0
NB_c56da0169001a662a0c8e4a3f7b2ea1dc8a69a817dfcbb321957c74573b6c82a,others,33,33,0,0
NB_af378b764853a2f1d9af04a1256049af9bd02deeba1af5b7306d49c276fd8186,others,34,34,0,0
NB_37026fa0e6a2a6cd92fb42c73e34569b2e658de6198aaa226a5cc120ae9c3964,python,28,15,13,20
NB_1f9e0d4ceb4ba0cce36f0b0cfb2480bb6a3a16b4911db794ac964def3a7d7bfc,others,61,58,3,3
NB_784b3661ef739e788b73b184c04669d0b2590b54424e4b49bf4412d4228efd96,python,5,5,0,0
NB_f4cbfb36df76fee5ebd9e2dd137c487c698140f4109352570ef36d90ac768a77,python,6,6,0,0
NB_64fc6685b659a1515d8d23b98eea34005e0fd075f6c97c64e3c8f7e5a769b8f8,python,6,6,0,0
NB_2a94bea9e44fc0a690e3a8df26cf59a33f2b61c157b40c220c85359f3955058b,python,17,7,10,121
NB_e98a23fe4621a6abf9d58e16e367e7fcb709da79a8ea83c0a192cb4c2cfb4056,python,23,23,0,0
NB_07248278e4ed8fbea42961c4ad5c868028c7c49dcb724b6f250b6195aa00c42f,python,86,68,18,18
NB_0b39a11b5db7f4795415451fa2af050f30f62e38fc93316addadb882f56aa246,python,13,8,5,5
NB_f6e6469618afe29997e2f7862f9de945c4651aa1bd2e9328929c395a01e0977a,python,2,2,0,0
NB_11f65a9167236526caa61e3f6324c90f78834e63e2c5aa6929d33831e50b510c,python,19,17,2,2
NB_8639170bdbeaff5da2bd599da60122eddb9ae66e83da4de23b1651aaaeb23980,python,84,66,18,25
NB_80eb86b68cfe13346e4a652499ff8c65281412100816e6a536df4a182b5fc1da,python,12,12,0,0
NB_e0b54afc0613908b59f7e02171fef21f6b00081a59bafca88cb555dfa3f49052,python,55,49,6,73
NB_d1c09797e72f0a1be4edeccb868d0a0b7d438a74b46b604cb9050bee386724ec,R,38,18,20,20
NB_bdae403a9a37466db3f4535a90beac343fb2485ab574bc9f3b345d2d5d9b9532,R,38,26,12,14
NB_4e619dd97fc23989571b2f94a547cc96fa8430e2ae2e6184480698ee0b8e063c,python,14,7,7,27
NB_16359ecdfd97a8db5896b8a1680c7eafc2f617de2b680f4d4afbace7110b0f3c,python,9,5,4,4
NB_095d8e05ba287707123ad0bcb366d14a042ac3479c5e993ce7f12f190959ef22,python,30,28,2,2
NB_329858c23c7881de6a5790ac63f2d10eed509bc6bc024d70bb0f54c1f8f5e6cd,python,575,288,287,287
NB_60a518d8b587889da34fe87d592837683fc81dead1613a75060be83382f36b20,python,71,47,24,40
NB_804bb8140a1a4bafb30d4e3aa908149a70c7e22d898c546d8409af99c7000da2,python,1,1,0,0
NB_8847ca47431fbe5b4ed5487395e1dabcda11d516df7011fa9572c4c3917a2c3e,python,58,36,22,22
NB_3315352bcc95960ca75af450a3632bc2e26c40c5e2e86ecc8572fab9b164196c,python,5,5,0,0
NB_557bbb6718e75cd50b4d82c1788e16c21b82c3905db8029fae0e5a7241132717,python,16,16,0,0
NB_30f6e32d84dded5eab8ed7a1d3cf5e202e45b3da40d3c235ff0530f092fcdffa,python,1,1,0,0
NB_229ef9650d00fe7c74e4fb503e20d025f63e65b0f72b3e4c7209063c050e3115,python,23,14,9,12
NB_65543da5191dd92e9cfcb87e5d2f835977f3f1ddc22a5fa24a4b5252f30ee69f,python,58,21,37,405
NB_79e52f69f2d46c2d633b99db42470e66733614697176738123b47ea72c6267a8,R,87,36,51,58
NB_d394780f5bc75e565d076027481a676569f0fb1e5a4ffdcb16e05b4d820ba940,python,37,36,1,2
NB_a98cdbfcde29ffe5f378eb421a8afb12f0bf43939b4e587cf4a8df6d2c1bbf37,python,7,7,0,0
NB_463ba2f5a3139669ef2fdbd3b825d932b53174017271b7fffe0ae2ade7c659f8,python,19,12,7,7
NB_1d9866ac0dea78ffcd57c0a7055abe0e86f8ab4aaf5889a362fce5726399d7fd,python,11,11,0,0
NB_3bb14bbdba8e2cce55d131eaae8b321110acf0a7e9b9f4f3f510b1593006e153,python,11,11,0,0
NB_d841b84e5cd5a3677ad6e81ecf9e2e3567e30c477aedebe124bd827770b310b2,python,46,27,19,238
NB_cd4ab0c62b09baa8d2ac7dfceebbfe8f4eb6cbe295c0ac1cc731969a74ed1481,python,4,4,0,0
NB_780f91f27b6dfeed4935b931729365c6b8fead8bba0790f82bb472bfeecd2125,python,117,47,70,135
NB_c527e1c71970a5f8aaa3f214f6b6aa2e6fd0543d9dadf10640df0a56627bc930,python,49,38,11,31
NB_5fc88f5c8f06ee77bfebd175474751d3b043f7781cd4c01fba8a2393ec39f0ac,python,8,8,0,0
NB_4e9a8ad6d94445136fd80955d28e312f65b896940abf85705f15add19d93194d,python,14,10,4,4
NB_1d4a4b71d8259c697e2f01c6e1e134be184e0ca04025dfc9efed3d4e26739236,python,13,12,1,1
NB_98ba2dfb32826ca7309bf8badcf99910ac1330dae975d5147cbf67e96da6b8cf,python,79,55,24,36
NB_7c4e5902363a2a0527b8581ee1e09a91c11b6ed7139f8841ed02bdeddbdb8eb1,R,38,26,12,14
NB_0e7be5107c68a708f9d636ef7ec20048d29e24b36791a50a7241d577e2245ea6,python,34,18,16,34
NB_170bc1bb0d1d940ef0b7208d237212cb05e97b375e9475ff44c9bcedd61c7290,python,12,12,0,0
NB_a2143162947cb56c6d16dafe702405c6593d8688a4c0d67aa3480b6f1f837b87,python,48,42,6,32
NB_b3055d32ebde189ec03cbc0a64a1ba85a603c2c880cf34247a1fb63d552cfbb5,python,91,61,30,36
NB_0f6509c443c041211950947ee5ffdbc48042085eca3cd24987ca80b3a0696a20,python,32,26,6,18
NB_33dfa2185599a224704e61bad005209be7040f3b021baf1bd07f4848bc31c9e9,python,28,28,0,0
NB_ed4c366cea17836b1ddb5555a7b936e2eda63887e8b60c7f3ce558c33bb564ec,python,39,12,27,226
NB_58add5eeb7a67ba14fe793a8fea4d38a8b8df0b753e30ca12648316bafc93664,python,18,12,6,17
NB_4a9bd6e009e8a977efe05b16cdfcc2857d7df204d351eee94b5614c0a44e218e,python,24,22,2,156
NB_3bd67346baa515dbd9c578ad07c8bfa8159182f000f726f880e6ff181cc7add4,python,27,17,10,138
NB_b4af3e7ffb8757d64855e2b332887b7a304564209b961b8c9bc0649f02200c5f,python,20,11,9,28
NB_2431738e8201d6432ddb5e2a519eacb4ebac6e3193b753fe15d9d641a8914bc6,python,28,12,16,497
NB_53ecfa92bae1b4e36dcbce7f8dd2dedcfc7577da2d21d83c85485d4e031fed1f,python,9,9,0,0
NB_c736a78b2c8f2430adce5ec2916707c478114a118bd242a592090bcb1254f90f,others,51,29,22,23
NB_8d5f71cba05e8729985546881c4210ff78f357dc93b70d89b89f156860843d41,python,49,39,10,10
NB_e455b25cdbc436c2980275f8434e7e77eaab321cab7d52b1079cd707a3411098,python,69,32,37,622
NB_b2845f9be2a43a8d6b8ce2b58a96ac0d98433f01abe57ec8de87fba9fd89fa14,python,26,20,6,18
NB_cca5b865d367a06e98117a1ccade0ee30350834d5bbabc23dfab367ae069cbdd,python,5,3,2,4
NB_33f4956b48192bf99e6ffe4e7bc59f897526bfe082956c3a7789f83c8fc3d882,python,17,7,10,187
NB_8fb47ed308a5a9c5ffbbb5dee51c15f10a4c41db379c8f38bcd7f9bbf21a53f7,python,28,25,3,3
NB_1921c8c9a027fe055e0f5af13e96475fc39b2aa3a1b7f528c1ea8105b89c5b03,python,23,19,4,4
NB_760e8857308f488a2e2fffbffde028a888e5be2c6d6f94f9fe19ef9c9e59d3c0,python,38,29,9,24
NB_387355803e6975deaf39a9c96170bdf184a76f51415a832d98378f78bf1b8202,python,2,2,0,0
NB_76587dbeff373625804b0141fc9061da493cff1526faa178820b8ff087690f95,python,82,73,9,9
NB_5952e1199a39d98ef60211f3daa0d0110ab46046392da10a9a4cf3b62977c05f,python,4,3,1,12
NB_f321d66e949bf7ad9dbb3e48011d412725a20e46537a582a31e65b7926777749,python,13,13,0,0
NB_c9bf8db4421d022d7fb863b8b7a978329df87dc682417957ba7d87774dd8afa5,python,11,11,0,0
NB_01d99788c5693d5d808a834eec7ba74cd50cd9daec88b64f9b42781b0b7db46e,python,22,12,10,113
NB_ce12962ab5c7048a8c9b1aa3aa060a61bd4d947f6bec9f656099d92c1ffc182a,python,17,17,0,0
NB_c3bebfd208a93aa06209464ca8d1e89cbbdf9064bb24544797677184a7dfd010,python,13,13,0,0
NB_ed9b73ab2046af79361aaaeb06b53d44811a9dfbe46f1e24f5ff8d096251c203,python,13,8,5,38
NB_51bba394416ec37ac201280e0f73ec1410ea5712dca868733a896f2cc4ef545e,python,34,17,17,191
NB_09943549560db9d019b61b36edefa64213a7730186eb2087228c9519cf1620d8,python,30,14,16,149
NB_be4df3ccc597758498a591a8c9cbd1fac142ca7fd0f683f42de5d62911e4a3fd,python,34,34,0,0
NB_b1b1b152f850d1f8739323fe9ef45c9fbc415acd996e62726ac4626ff5333a6e,python,80,63,17,21
NB_d61447025220aaa16c6e170f89311279854e26d9dc78fffa3e91a0a5699899d2,python,9,9,0,0
NB_ce492544d00874ca1fc61e7364f8cbc54f64341428d6fdc9ec1886cb4851e200,python,19,9,10,52
NB_40c80f4fbe963164d37ea8af9d032203bb5c58f542265b5be219035ab1d7e81e,python,8,8,0,0
NB_8eee3c6e541fd9c53ea5885a799ddc87f5a09874d32ead0dfd18439e70420e63,python,71,31,40,111
NB_58bf8447aac9bb67d475c016ea1fc1d4664597383f698c060fe060b680635f1a,python,40,16,24,115
NB_9576ac3391a7304961d0d6f8fb7fa4751f9388caf28e4c845b67f975f2f4d6b7,python,21,10,11,101
NB_b6e2ade69437a22bf45997d24d94c434a2ea6c3e880cdbec4f31f258eec0250c,python,20,20,0,0
NB_321b732874c9249f4e4f839752eed1595f7a64dbdcc191336442e9413c29a57a,python,29,15,14,91
NB_b14e2cb2a30940f72dc50e0f2339ffdbfa5d3bb692c06d5787a6e0f2e46d25a7,python,22,22,0,0
NB_807291ab00bb0cb4b03ee5b6824f39b4ca8e91a6380f8536a6aa34646f0c8e02,python,31,13,18,19
NB_7693be8acb400b7bab54b487550489be624f2bcd7c91237a9fa5abd97c19c4d2,others,5,4,1,1
NB_cd807f8822ae21c9f31a35447256ed0ab8b91e4640ec329c581c22d47f0f57c5,python,51,41,10,14
NB_91a85f93b73ba6550af08e3db2937f43e6af1407fea272403cfa910f933db0b7,python,84,54,30,41
NB_e9876d82d7d9bacd28c3ac019203cd2c66084aef7042b6118750b6ad2ba0de61,python,9,9,0,0
NB_098023190721a65de82a75f877d0adf87c575210a294b660b6374536c50f49dd,others,44,29,15,21
NB_0aebe77df2ab6af0ea760aa14cc46fdf515c22c0840a69c9e732083a74a0981d,python,41,41,0,0
NB_1b1a153da74ab6592fa322a5679a6e27e1d49a29c95a30dd85bb047cc07bc872,python,7,4,3,3
NB_88720d29ed21aefcda45d00fa9c36588f106671134253e5fbc1bf8a3e8a6b88d,python,29,29,0,0
NB_0bb94c84131dac506a8663755953dda036050c5fe3168e19292746040284907f,python,42,34,8,10
NB_3e9396edaed2cec335e44765526fdad9668cd5a75dde77154a4d84af4017290f,python,3,3,0,0
NB_91e47709fb7dec5a87162577a1b93e3da145c807388fad2ca6305812ac537c94,python,23,12,11,31
NB_3a14cad6ff19be08786f76a00ad5ba569d36449caf98b6babfe6d6e894720b34,python,9,1,8,246
NB_2a22131064d1f2ae76187240d5f0f87afac6f91fafe714adb7479fc645116ddf,python,39,20,19,68
NB_2f75c1b5e36a914a76536d10688dbed1224c258de648a60223547a41d2ef53df,python,35,19,16,40
NB_0a78a30bc1a8b26b92082e62a0bd089e7504f7603423285e8b7de896331b971f,python,3,3,0,0
NB_983b005df038de1cb8f3ca723e3dd16c6a6e2155c4394a064ab7a9f38eaf76a6,python,24,15,9,11
NB_2ec5af17ad2ca3a999ed136227bdbd193ac93c202161b4174bc986b5ec8142ec,python,4,4,0,0
NB_850e969e99012e7394d38ff455f67804fbde5e8a38536852e129c24e992bc6db,others,7,7,0,0
NB_b92adf938d72ea0653e3de25fb7486a1d9f211306bee7e3dafe547864c5eb12a,python,14,14,0,0
NB_26d8f53fdb66811b2fb23eaeb0c421bf168332306a3af187eecedd5b28279dbb,python,7,4,3,3
NB_7119984772d4e4133e296bc1d141f4aed77c68dadb1500e44be17135058f11d4,python,18,12,6,6
NB_afd46da170e6797c2fdade57b9696650b93d22ecb778581f4e512219a02daf9f,python,43,17,26,230
NB_597493125588061b5efecd4f49dc69aa734040ebfa1a24a4a6ee39d219120e4b,others,12,12,0,0
NB_11668ef9a5aceee3683535824f2672bdb577a7ce26ac86557c1a741aebae9dc3,python,13,13,0,0
NB_9d9c64ccba48933b6ce70cf1cbd81e958854df10f5cf359937e1ee9cea0b158e,python,21,20,1,5
NB_68ed2834b81511508da4034abb862979f9f42863a856c9d50d5f9ae5ae0497ca,python,37,32,5,10
NB_235cb2dca0c298bf8c9eaf02bcb9c64c48bbed1e3285b70f6d2e73e48aca6135,python,3,3,0,0
NB_ed5b37e01479f87b298060155e7ffdd36be359cda6644b3a7990abc2ce93ab7e,python,15,11,4,16
NB_465d9fb6d79d15a2c02e683b6c053830f85531086fd06c85cc4d764b583b3cac,python,75,48,27,27
NB_3b71adaa57e926fc178d061ed2ebe3677449018b075b448e2779afefac7ba939,python,34,19,15,25
NB_9dbe7393bf2975faeb707981deda782d179af9df185ecf0c2ce4c35c88426929,python,35,13,22,257
NB_89f935e27357583da03f169179de02bed8ebe48eec3a414d71ce740e973fc6fe,python,43,17,26,230
NB_30783df662add10abbb6969d5f79bf753efc9fecc485c565a6840d1e0dd32416,python,4,4,0,0
NB_f4af83866dfbf617b60e3c0e27ba474cf06a0f249b8774f6a260d2ca8061098b,python,11,10,1,3
NB_922906149a38823fec703718ed3622443c21bf2f00837c3909b34f5bbfeff38c,python,193,173,20,20
NB_0326d1332d17044722dd4c13ed59a43d8dc7bdc1d6bfab526c733e0ed1accdd8,python,11,11,0,0
NB_c4c8694bd171dcefd7250d501ca0a666c7bba4200b5d573e4a3b9c4d8714d1e2,python,40,26,14,14
NB_735df44fa08741f9f1cc637eaf0fdccde601fc231fe0c37289de6e7c72610ed8,python,14,13,1,1
NB_650ff43991513cc5ca8b254bacb04b034f274ca5e051ad8461744af3f20fc1fc,others,9,3,6,9
NB_eecb52c66656daf41c00c971f72b05a517ee78e4b748b5d22ed0dc315054861d,python,3,3,0,0
NB_8f80ddf681c8f5c426400ffa4dd8834c82ac12c6734cb4c0e3fcd36ae6c49381,python,478,363,115,122
NB_7f9d1b67dc7c38f33a132327a241e2efb941ccb2981c6f3fe622ad0ab37c05d5,others,79,78,1,2
NB_c39a6d98210cb828e67631f565b73b49d9c0c4a26c1fb9ede3cc20d16b290066,python,35,26,9,23
NB_eaff0001f2fbe7259a99102729537c90054985ce1bd0eb6e8365196643bf58af,others,7,7,0,0
NB_5298520b662484ef3c8d63a64b66dfb60f8a9ce8e9677db48c00861dbbc6ace7,python,4,4,0,0
NB_d5c1a6064290d8fe00a3f9c9518cfd7bba4e1ebb4d21c8c682f32365c6b75ce1,python,31,31,0,0
NB_74b7b67e1ffe315a164eb4ba64ab0c5f8849c4efdd04c6499f7e93011887c277,others,33,25,8,8
NB_0f84bdd7d21d7157eda52f3ac57b4efa0ab4dd020604bc80407d1fa73df46008,python,32,18,14,128
NB_a06da5c1d9a5f1229773613ed95f0d451d5f71d7e1a8f4e91119ff2acf91d2e1,python,41,20,21,243
NB_003a06284c07027ef4c1454dc9b7492fc2d38e892baa0ae9a44a9fb7a9ec711c,others,27,23,4,6
NB_236442ec53352efc6e6d250dd3217d9bc419ad060740ea7b1b9942cfe7103ad2,python,56,33,23,56
NB_ded3e4fc9119176407a073beeb5638eb594fedfdd2765af852bc9d692df83625,python,20,10,10,59
NB_69ff2def07bc563264f07490d13eee641f309cebb0e837816ebf4c358f8011ca,python,10,8,2,2
NB_94748dce1148c6750db77b790607955b7547f8e7a6df26e064b19d9383cf4b46,others,95,67,28,254
NB_d6690362d2e039f2cea4b96bf2bc3783be853c8a4484664840163302e0c76f97,python,42,22,20,47
NB_504eaec6561236b6d15d98f399c29ef0c37077446b906d59d1595cb523351e1e,python,18,18,0,0
NB_9d55263aa80d505d0c56808d4c5945f88c9836c5c6c068d5ff08c6c95dd5b7f0,others,14,14,0,0
NB_b3fad393b7d8dc72750236e00ce1493c68d1b26d35b42e432d088d5c6614783c,python,212,112,100,508
NB_e963caa4f5674cf5ef8aa4b36491ec5911dbc0fc714ed4fa96fc6984585f536c,python,8,8,0,0
NB_8ab0ac57b842749da9a94b221f077876994270067f36e49506e6f17695ff90f6,python,6,5,1,1
NB_449be9eca0fdaf71021485c9ffb7d473136f4151cfa601174b130ca4d473e568,python,40,26,14,14
NB_ecfc8115eef7dbd6990b2688acd5cdc4890d8c1d469b45c318b9330e2a011010,python,33,15,18,38
NB_43afac3d91180ca16d0ff2fc48aec59c5c5773d4471989d865e23713e0b6e3e1,python,57,57,0,0
NB_fa51cdc5dd46873204db95f2ae9ea5ac8df0b06f7fb0515da2f218be437d8e81,python,18,16,2,2
NB_8b0ea1317eebd9d8ba74572d8683267f0ff27a8221f71eb3a589ab5413ef54ed,python,3,3,0,0
NB_e21dec993315ec8d3e9d703823298e60517826450d12d20703f06a90edc6d8b0,python,53,40,13,15
NB_2bd768d716d5709345d3af020c0ccf2cfb4dd71352bd2c7bbe3453d3b5ac0a4c,python,10,10,0,0
NB_46b92cd30460a7c2885b4531b6597bba63557a79bcb7f855385a6ea7a3828e70,python,26,14,12,65
NB_e3eb53273901ad3fe9e55bfb88aee4c853c994e87fd580ea56be365ee4593031,python,20,9,11,11
NB_7fe2e55afe9db2562e176855f0a4f97eceba6f43dff38c29b5079feb8ceb6270,python,4,4,0,0
NB_9d88d94d40bc6790995b8ab45471cb28f53d62dd47ce4c6d26174c23c51865a2,python,53,23,30,453
NB_c9cd0ce7e9c3e74e1a0befb01176ca2ccd9bb956f575fea4589a9752ffca286b,python,11,8,3,152
NB_6748a7226746d6af858fb9abe8daec27b22d119a3b515edbbfe0b17bbcc02123,python,71,69,2,2
NB_df0d126acd11b41f812f0cb10f385f605cc8896e621235aabee801a276423496,python,18,14,4,4
NB_15fcb333b0bb59387e31fa9318e5a026f901c126f4a602405e33444b7931a726,python,23,13,10,18
NB_8203156afb088a984def6e5e917d00c36bde27ec824727af3c5cb18c1a0846ff,python,102,82,20,171
NB_cdc777e9269c62b7cc5951457551a0d83ea86f20ba4a5e0f98bc125f52f299f9,others,18,18,0,0
NB_b1dd229a35dc4a46e42d495fe3a4ab78a909633b2a1e807927f14b4ed4489dc7,python,26,13,13,71
NB_00116341e252f39b63a6bce19b2b9fe147acb921709533f289f57aeea43b2fe6,python,12,7,5,37
NB_cccafc3c30b9a8aa68aea5c495e8c51ca4b5b6e5affbbc8b41ba8c36d4b20e8d,python,36,15,21,251
NB_7c463617cbdc9b5d4b0fa5cdbe40f22a85d99c5cb3faf606c5c66402e9a9737b,python,59,28,31,378
NB_5e2b8b90a68905089c386e66edb51bf97b1555676b39fb34f2fc8711b93cf940,python,1,1,0,0
NB_f6c210b0e2d2fe907d857116d756ed45dbe6c2812d2a955c7ad21821030593f9,python,8,5,3,3
NB_519fdd3264b01b2b5352e01a4f2cb3a4d88f881141a44f790b3476ce3525defa,others,54,43,11,22
NB_9090817ef2c3333fd8783e7ba5f349d9db3b35d05335f980d8b59d394558229c,python,15,14,1,1
NB_ecb5b71f2e239e0cc90605c319b4bde62466270a62ca6ac20b1fc476732c17b5,python,1,1,0,0
NB_1bc7da25eedf58d4e2a41973c491f2f6bf990449c3c752c8be8d9a560bf25638,python,23,12,11,65
NB_8519def5d1b0813ef4d08128b1182cec91dce6d05294a45b63ead98bffc7a868,python,12,8,4,4
NB_2bb89047e5afd4895e0f18addcb0c49a069527fab0febe017ea45623a599fd35,python,30,27,3,3
NB_edec6af3ca024824109acfa1b8e0027171885bd3fd2900ff069ce17ff4d7833a,python,2,2,0,0
NB_ac7707ef621843723b558709db65697d2d89b24efa2666f5cb79a004be410a6b,others,28,24,4,4
NB_3fb7a8805561cb6f99d959c59570697aadd17e363ed8fb31e63a9a0645490be8,python,6,6,0,0
NB_a7645590b1394fc2a930b60e62fff8f983f04b126a2afec247231ca659d3ab6c,python,4,4,0,0
NB_e454f8fffd3ea10280ac29fb81bed0f9b3b51289ce6167d25fdfb8fe17930002,python,10,9,1,1
NB_ae3e0cd8b62d3687e5c75796c34de4e6866a6498614820ea563b129b67f758fe,python,41,20,21,186
NB_cd7d5daaf5bbf16ece322375376797b3e4f15d5745689861261e44799383dfde,python,67,35,32,38
NB_7264b76cb98856ee13dcafc6f61f177fc5fe1d424bb65e06aaba36fb3d24a096,python,18,11,7,12
NB_64eecb19f65721c71bb75e2d0797ed2100026864e4145f7d08184cd4ff0d6254,others,33,33,0,0
NB_0775f1a50b3bd4e9443e038bee56985787c8c746bebd935cd828c187b4d25d7d,python,3,3,0,0
NB_c399273b67c576d63b9b870157c2052b9518a1f0fed77e83941440337f5ec4e1,python,56,20,36,391
NB_dc2856994dc87f7bda7e16e707e59e9214b5b68624d369986a6d5557ecf9802d,julia,5,5,0,0
NB_299bc36886bb2570d3bb33c3ae811a2211038aebe870d29fa86473db37d2d0c3,python,60,37,23,112
NB_d38425093bf0004b94a4d57b7a7d9f708ae3cd2edd1c6801e597c15f1b7658c1,python,10,10,0,0
NB_90a6df7126d633ccd94f6de4bec167267bc35048617a35949d4b1dc1d080cc14,python,46,25,21,273
NB_ccbecd53a4d733e90e846b8613c020134a4675e2d0146993f04abb857baf9e21,others,30,29,1,1
NB_bf162b29f2015787000165e96317b97608af9fbe58f7da675e76de4b6208567a,python,5,2,3,5
NB_f22e8141bf0e81ad53f7d88c5ddcf404fbcae8715a5788c5e770d5ddac8a75d1,python,29,29,0,0
NB_4b42c81c818f5f5a23038c1219cda6c46b7147af6facdac63fd203b4e96e8647,R,69,23,46,147
NB_93986c4789ed026657ccdd43ff1be48460ca8f8adfd0fa055948dce5ccbbf21c,others,19,10,9,46
NB_2eb5f00d9cb03116b0e889a574ff7bd2f0250e6f15c65351024b56bc72e35dcb,python,32,16,16,118
NB_c191575b0437b74ba500fd8e4043d218286526a668ace6f7ed2b7711f2a02d08,python,86,70,16,16
NB_678e6dc0fad7d77b911e9c02f892f17937d484970b55f4714e73a636b2dd1ad1,python,10,10,0,0
NB_f69e56d22b603911bf653539ef15e70177218fbc7fa3436b1e541442331d34c1,python,50,38,12,12
NB_210f9a6b37829326b4b662bc69fa1d599082b7edc9bb86e9d98d61a5fa8466b5,python,25,17,8,24
NB_470795bd74e226cedd40c099dece2f3d4d301069f50a27c2050c79485a6955d3,python,26,21,5,5
NB_c6244fccf86b5ff7dd92a73116b7ee329b465fb10150d6ec8eabc388ae2dfa7c,python,4,4,0,0
NB_fe7cf011bd8e252a7644dbfc90a6b2c9622fa64d0de58f2b63fe53a5540796be,python,12,12,0,0
NB_531722b995b9ce30598f3f79e27eb5184d6887c96265932dfc8261e778632f4c,python,79,25,54,224
NB_18f703bb4efd7d87b9a0221cd09f144834186b0397f07f57cefe89d104cddde1,python,3,3,0,0
NB_8dec8ba4f168880587f1b8e37ddbf9f0ae30b39617581ade21b7b23be92f4038,python,18,18,0,0
NB_8864368cb73231321c1f93603eb7bc4c978fd7629443cd64e5a01832e6af8546,python,30,26,4,4
NB_e98b1fe78105d33f6b8992e55e9d49330c8e97be963a6d07c7fae4211e34519d,python,1,1,0,0
NB_c8e828454603c1baf408b8792451bd286a809b6aa141ab0c3e94a12e1a9533a8,python,26,11,15,273
NB_9bdcf8e9e237ab1816f450d43997ef8a167f053836a19f6ff04ee475a1f4220b,python,54,35,19,132
NB_bc43c81e34a48c8e8de38026be33a0b817220c9f80b94b6d82d1bacb3bc976ca,python,27,21,6,6
NB_8d4f76a4ae59138de440d0e000f03a0e8262e17b8eb42422d625e7435971d99d,others,82,55,27,42
NB_baa037e5f735011791ec34cf297a8eb3aea616867e08fd423aae3be1013b5fd1,python,22,4,18,65
NB_b488aa15d48820babc3bbf4597359b75725ef788ac3049d5d9be6536d7785668,python,32,15,17,204
NB_ba51b20fa76f452dc3fca3420ebd29205f4cf99b6e61549632d152cab08bf683,python,10,2,8,24
NB_585530731b7590cffe891af61b8bc1dc904c76a009eda17ec4a63030980086db,python,46,18,28,466
NB_91bc5d877b6866bbc746c0e76e3171ce11f5bfdcf6902beac04aff0914f91ce4,python,11,11,0,0
NB_be027206dfb68b0252662fc1cbcd31d44dcc32ff4b9cef6f80c1a074e56b6ab3,others,0,0,0,0
NB_1a13c8107cdefa278ebb567d5ba836c4e9e69f8e7497cf207b5f2378fac95b88,python,19,9,10,29
NB_c37c1479621f7f361c17ea21ea7c83abdc58e33eaec776b598e3760a7f31635b,python,34,14,20,300
NB_914a71b53e465c07781d14b4e32491b787a7d8cbe701fe6ac33ae3b1b1e87841,python,45,26,19,26
NB_4535c88679aed68ce7131e0bda654c3c412d976d640773bb7a8e624a87252005,python,4,4,0,0
NB_736b66cbad7d14249a908edf21a2da0de2453298a6e82f9f19e546b9315ef2eb,python,68,29,39,417
NB_60b5cc71659fe8740998fda3e060d9e164412c0e0507643588d2dfe91f102b8c,python,12,12,0,0
NB_6ee19e9d136e1c96d2389bd2b5d0449e663ccfe3322cf2879aa6bac4d727dc1c,python,8,5,3,3
NB_c857da852051f463ac74d5ea25676f88353eaacc7116eeb1264a558b1a3af127,python,2,2,0,0
NB_18b093eab00ecb66875dceab06f447b5b0599a13421ea75474d1713e40d6c852,python,7,0,7,196
NB_57b7da9d20402dd06a8819e0b9a09a73eeeb0f9724bd2a3098490a6720be43e7,python,24,13,11,37
NB_aee10f31713a6c3ee9569867516b2b498cc21f148f04e7c7b8b8e48b073bc414,others,73,51,22,30
NB_c4903f9cd21b24b747d7f5c1ec2eb58d93be705d5d9aeae1ea0883dd773ef6d9,python,9,9,0,0
NB_c39aa10b8dcbbab0ecde01a63b1e00f81ca22b2c0f4a90a7f5185322867749eb,python,3,3,0,0
NB_5b70c1800e039e5dbddc1c7c3940b5a0b23e7ea26bc49b3a48c2f112f3c77c5c,python,23,19,4,17
NB_d08d243f682e30aa8e7644875329a267998b61f039bfbe9eb8a5dff6b4c0e789,python,20,11,9,59
NB_6af73cb9dfd5b4dda7fedea85e298090d8daafeba0531e69ef5290e5371c4288,python,41,24,17,102
NB_584f7d5e37729f0305be8641f384cb50b63f384b78496a6f1a01ceddd065637e,python,46,27,19,24
NB_48f2d1d31e918e46e9d1c361ecf948e41d0f94efd821faa3eba673fc895739c7,python,72,72,0,0
NB_d8a8630ed9754f54453fe5074727a6d8eb76678361ded975c2cd4049284b8323,python,44,37,7,7
NB_8d984137a98bc37a461bc79e20e3f97d4f11976122e40689d3bb92e07809844d,python,11,11,0,0
NB_060ad83205ed01b5b990374cf8b74bf75bb3f76e85f332b6b957a6cebee3086a,python,17,9,8,44
NB_9ab8b9700e227a47be015f280bce24056a0258532c9e3b217d0892370b20ea6e,julia,7,7,0,0
NB_1a449ed86657c6a34e6c3d7ddc9ba795aeabab7b566a507d5eaf86ba4d7224a6,python,35,35,0,0
NB_bfd2cb334c01f202025cde6c7a2a6e2a0a7c00e1e703b698759a91c49ba55a32,python,4,3,1,22
NB_93ed382d93fb54613f32f626da9e17d2fe5380812cfb821e1104a8c95e80e48f,python,8,8,0,0
NB_a1fbc919f662d59268d20fdd345ff935fc332c424024cfb66eb6fffc2188b0fd,python,18,18,0,0
NB_8f14e9d90b97c43a1bdd8050babe7453bd404c641936390d50c3ef81aa376c94,python,3,2,1,88
NB_3ebc810d8303a91d244b4731ba3c8fb36f699369b3ac15bd984a6d428ffee43b,python,8,8,0,0
NB_d77f15069cafca37f1ee0ac459c1a9018a89576584cde4cb47ea701740709cfc,python,8,8,0,0
NB_90fd81ee508cf6491de29b45caf5e7083ec9eab2a8e46c8e3940ec7d230045c0,python,10,5,5,30
NB_f0d5778c6d08d94c95c21a5a7363193f86615b2af9d248a4683c7fef7c6d45f3,python,32,17,15,83
NB_8ecc8bc845403e08ab8e1b5c247a041c2711b022392f3da6659c5f64c652ed6d,others,0,0,0,0
NB_3c1a4c04b0aa2088c9c67fd02f79a1031d5e196c18627a0085b609f7e1731191,python,5,4,1,22
NB_5d1f645076abdc5fa0f0e521e8c657eea5a94d7b0ff22e2aa34d8bdcb83ee0eb,python,13,6,7,9
NB_e9f8724e223ea70c32b7e84e2dafe00d34a516c23fae5b0ec3855ddbba5e5810,python,10,8,2,6
NB_000faf57d34e7380cfe664471b01c42ef311c21fd4646670c4a839a84ed14e02,python,24,11,13,121
NB_1b7218494c96aeddfe22449a126b555c1123f33bccc6400b6b6373de093a1397,R,13,13,0,0
NB_136fba3b742f6463928b1ef7183a54af62f3b42d40564dd5306e04475aeea17d,python,14,6,8,123
NB_f48e0ee143123e0d36eb55a2e04c2792757ab85123d189169d0f22c4b52148e6,python,37,22,15,336
NB_9aba8a92adfa5a3c6a9d44ea55c0311c3343f255cbf99020aa5956853261ada0,python,37,18,19,252
NB_ed4f6d6ce00b35fcc95519b3e2d62fbc3f79eaf68ce801a65d032fc000e67c95,python,27,12,15,205
NB_57abad4df0215c8650df790bc5a70c9ff2dd5c9d8579cfee7ace352c31d559a3,python,20,8,12,41
NB_313d4f70de14f201f106d8312f3ff9924d7ff55d02626fb5bd8fb61b2d2ae85f,python,81,53,28,81
NB_b3f2e6e515dccf2e8866c573e9b6981fed5ffe2854e7db8a8f2374e6adb5b093,python,13,12,1,1
NB_0930335b1d6a43aa7645da7b13890078dbc4be7421c580eeeac2850fe80cab7f,python,35,18,17,38
NB_3eeef23fb2c3920c69710e76db485446094de892e7a4b4c2c3dfbaa5b38a3bd4,python,7,4,3,3
NB_9945416bcce67ee2f3d88c53f7cd512f63dacd71e8a4c22137f7f6c9d8e35dc9,others,58,50,8,10
NB_2418393502bfa8910eaeedd8637e56e094fc99359cef11867fe9373b8f7134ea,python,52,24,28,80
NB_9542eef7069630cb11f213f25af9d6adeec1369ebfb9fcddb21c933a35c7b91b,python,75,48,27,42
NB_36be18a533053cc7954e9cb133ae0730bf98f7c3abbc82f832eabb8bfb96a224,python,11,10,1,1
NB_982a04ad6ebb5edcb1d622746a0bd505dd724da6d3d9596c97f0a53d08d993ae,python,12,12,0,0
NB_feb2770381954505aa1592e0c0368c1b8c61c7e60e8b3a9d7efe7df54ebc6bb7,python,9,8,1,2
NB_b3ca383ebf1d48cf5232e8b2d950b253dba6442f6debf953b28f02a2eb485409,python,12,11,1,1
NB_d3b9691a199f2ef3e7d1c23c2e1f96b9d231997e112befaa954115df18742bb8,python,29,28,1,1
NB_d7a2662e5b9e905864403707aefc10c3ec727158f3438dbb6bd01a636da7d078,python,16,14,2,14
NB_410f522cf275987d4998ce1561395ace131ae95d4c5cea5522ce314798b1cb45,python,7,7,0,0
NB_233aa0e8b6ef6fef70f29144c0c3cf2bf176ff6bc11d0108da5d9195dd42d3de,python,32,5,27,94
NB_c1e7dd6de3b5ce098759853173ab8f665bad75c25ed2c00d9273c1622bf9e2b9,python,39,12,27,227
NB_19d8c2a74a64906615e075c85f944d23c797b0bccd1d0af649a929a8a7f7718d,python,7,6,1,8
NB_cd08f7146c6bbbf012ba672e5b1ef80fe11e35ea05b4d87ec82be8748431820c,python,22,12,10,113
NB_9298a5846b11f9e45a2ab76a892a86ff93785c3ac7ea3f119282e1e10369581d,python,23,23,0,0
NB_d075fa9c3a9de8d3323d7faecce009273d602044ae4f53b6e18b6d3f64acbcf3,python,22,18,4,11
NB_c9e7b4ac9f59676de17029d80a6f43edc4964c222d86afb9c908b4560b26b172,python,48,43,5,114
NB_bc490d1ff964f8df4c6f5d811a89c6a771d27203a7ceae8c0e70576a52855787,python,16,0,16,101
NB_2e2ce76764a2318782af8c748096a66d9fd196b9298de6536db110ff20fd498c,others,25,23,2,4
NB_9d1488be7bcaa27a48f751d30df1a751b56626b37ca585c607f5e27720eda240,python,8,8,0,0
NB_5f1b70119ee75b4896a1b896855f616f0c4e81bb04e5b3cdabd79782f6cae918,python,86,77,9,448
NB_1f942371d413961a716f05e7eff306c3b4b2e253b84a33a19a2b440acf9c6276,python,87,51,36,67
NB_9755aec49837f94724666872a33be6c00912b713dfff1f6139ca6a2a8e5f65da,python,2,2,0,0
NB_31d86b978f79ee12abcc5ff3d7e412f0dd89bbd3eb7e11427638271968b62b3f,python,23,16,7,32
NB_700a9e1cb7e1af37dab1bf4a38bbdd6e5da0ef3ea480ae20d2d11cf70da526ed,python,17,8,9,35
NB_00a19fd7a7c64f7faee36c5414293a2bf09ee292171939aa88fb55eebdbf6c67,python,27,17,10,10
NB_2684377e72f919250606d7a780755acdb83fa9ac9ebe0e6602735b7f1b07f89a,python,127,109,18,26
NB_637181b077f07228c840375fdab9ae79ada4b8b3a4e06323a31f571540b279ff,python,9,9,0,0
NB_e5b96702b9f62a475f41c4edec57d0a5a71bd0825c71593ff3dfde8f02daf3c8,python,5,5,0,0
NB_1576e02fca0c2c05004cd6fc4512d8dfe3b5d7e3a624a91d72439e8a07f8f42c,python,24,24,0,0
NB_8550c5217360a11fe93398b6fc566735c3d66c463db4341af079bca00cc6f067,R,55,20,35,738
NB_d1c50d60218e283750da42562e65ee01f718afc46785100443221de37c713966,python,31,24,7,12
NB_a56e4916cff08d42cb4db6ccc85e589ea7fd91eb1d1ab36f5ff9d7864b08f7ee,python,13,13,0,0
NB_cf0c68936376577eec091e3af3aa18f13296b394a9c587badaf86efdb205af0c,python,28,28,0,0
NB_2db30cfc61d8da45484098dbc5176cc5ea98a82ec03dbf627663fc284d1f9e49,python,34,17,17,190
NB_0bfe4fc8a37a24fd7de3a6acfdac58c909393e60ebc7a99fbb1acb71d3036893,python,13,13,0,0
NB_842a01043e371dad188cd8ed61b092333f4dc3d8dd933441ff7f0bfaa6f9311f,python,16,11,5,5
NB_6f3851539c7c3da0954eef79549b3d249d75dab2a4335cf8c54f9da3b5481118,python,29,15,14,82
NB_d51a86d5c5ab8c7b6b5c179b6cc1bc39ab85b0455cf177c1a7f57e1be21bb780,python,28,28,0,0
NB_6e6405a806fb8dd4b7f3598cc1e8c50686b4ed08a6126cb2c323304c401a2390,python,14,8,6,19
NB_5fc39f05753c05a97894586186d9fb74648612ba6b1f1a802c839da178af440f,python,31,28,3,3
NB_5465d38d1c5c477b8e1700ace511dbb17eb24254bcfa29bbeb3839449bb0de95,python,7,5,2,2
NB_29e0eb2d542190073b3099d2284133f497c409e1376b474566426320d32959f1,python,39,26,13,38
NB_f0a9d931c924544a7aa908960fc580f9ba06f7b8f48103004ec28fba2120c5ec,python,54,29,25,44
NB_cc48ea60f1f589112d3ce2d3009fb6f8aa103f26ec2458ad6da6d8e680682c5c,python,5,5,0,0
NB_5e8df9d12aaa8ad3bffe31f6d53717cacb6099b067983a05cd3c3316f1ac29dc,python,35,35,0,0
NB_9a62e950e88c1b2e8c78bd5dbd30b17423f8dbb1c47f1157da3ee042a1732a15,python,45,37,8,22
NB_0ca0b85d0c3369c5744005bf262af8f02ee43a8853ae68136c7ccfc0537565ef,python,6,4,2,2
NB_845c38cf11b4c09485a77ade8db59dd5ca937541850429c61485485b337715fe,python,12,7,5,13
NB_1de9b6eaaef66754b2266d89b45cf764947cd3ac251f6cd2515ed9acf2072bf0,python,18,18,0,0
NB_e5eddeceed9454fe4ccbb03596c2f149f8657776c7adea806d347d870335ccac,python,41,26,15,40
NB_fe0c4b16ba0139dc6c04b2bd12b847e90e460d01c66bcef60c48f6706b2bc5d1,python,12,5,7,85
NB_d546acb22babae47d41cc44b5b1669fb3e89338ac54d416fb37f17136af52724,python,47,47,0,0
NB_97e13025d5a246d9f3780fcb36fd0f1e4b02218feafa5416fc7a56cbcafa27d4,python,45,25,20,218
NB_3c2867c6d91f81aba1243d67a0924fa83cec4a8264f9c6ffbf56649240ee8aaa,python,14,6,8,89
NB_2ba9f9b6d28d24aa35759e0addd548bd3820bbbbd8c686611892f3e7f988f6c6,python,11,6,5,5
NB_5e22f997d2b4a1350d1be2a17dec6f193eaffc5ee3e9dee79498c2ec3794b986,python,43,29,14,30
NB_3edee2407a67e0bb929f9f3930012b37837bb2f584232325cfa21123ad0fdcfe,python,27,13,14,155
NB_61a1373f5f52e667f93fb45d545ec15138338901760466dd7a4276db964dba50,python,13,13,0,0
NB_5068fe539a882614bca315ebb962904798feb65b1bafc39781f1d6271e4429b3,python,14,13,1,2
NB_948b15e15468dede1ea07b8e446702cb66d9bb68e831f6b08526cfe57c89ae62,python,41,17,24,490
NB_e7d5f6752b12020fea4663f0029fad69a1a6d850c8fee3dc49d21b4aae25e229,julia,5,4,1,4
NB_5e5a3a8492cf46ab2f558d1efd971e01bb518f553b6db458b8bf220615854ba6,others,15,14,1,1
NB_514df9fa1f51bad15e4781622f8ee759808eee00dc6752afedc5016dd66c0870,python,73,73,0,0
NB_ad5ae07b40b2f1acc2d712da538476bcf5282af72c2a061e45bf2ca400a5a190,python,27,13,14,59
NB_7a340a0df1e1c1ba0bf6b19f51f2bbe61a537000033e20ad159b9d2ce9fc3610,python,45,28,17,32
NB_f1514744da5709859348b788a6672bb89a8abf6844cb4f69ed61cf1ad3089307,python,3,2,1,1
NB_999c821129b733a0a204ed1e8fcbc24bbd87be990eb9e87e7efe07bdd755d3ff,python,6,5,1,17
NB_4c9ee9ba6404faab5df4d31fd9ddda5b2ac334692ed80b984eaef5f8fe8ac57e,python,1,1,0,0
NB_6852d9775dc73d1da7f49b0855c4efd2a2231709a16ea7729a7ea41c525844dc,python,45,24,21,36
NB_2161eba1fc894d772a47e23cbad79e1507d7b7434bfac9b814d28c006cc4c5c5,python,110,89,21,29
NB_7b7abb960cbac3f8605bc259e1fba5873ebafd065729cac1cde6abba00b7e726,python,17,15,2,2
NB_a7e90e161d6577c28f2ed52eb965fd7956ab9dc4e40c9c1ecadc68f71454521d,python,14,14,0,0
NB_8f0cb35a8736581618f2e9cd6797c4c3f94bf1ece7c01c2a9056c91bb4f7ab40,python,38,34,4,4
NB_eccc8779cc3771333d799b870379bedda07aff746eea6cdc7b0a3f509601aa21,python,5,5,0,0
NB_05786e5ed40155a3a109114d7609c7430586470a3a2e964784c3192b0e2baea0,python,12,8,4,4
NB_0b69399cd76b73ba67cd3a7e1971aee7adf202b2d2363a1d21723e60c426b408,python,2,2,0,0
NB_4c33aa1886cbe3db2facd1967fc5f87be5201bc9689216d411ce9acaaba60aa7,python,56,56,0,0
NB_5754522039e25c690163271a9df3ca75e54c2fdf808ac140e9c67b5e5303b93a,python,11,7,4,8
NB_4e201619295026fc2bbe059b29ba0291b981329825582bbaea6424ea1de9d70b,python,3,3,0,0
NB_52db10aac3cffd615076c8d4a70b77432ab25273a858ea0482a8de542ce8fa48,python,52,51,1,2
NB_db9c145f7db08c2176c304c3eab02ca30ea14b4c8453f706a8b4f64b11cb865e,python,15,14,1,1
NB_a6b0bcfdb9f5a20dcfb7dbfac8f8afd656196ca17ce4427e39a70c81a82e0264,python,8,3,5,90
NB_0bd6f466e8febe2a8f4ce3515021a8908fd1ef68bda4080ec77d1e7963e15b7e,others,6,6,0,0
NB_0ec22523eddf573d0944b38503e547cee635185e54b0fc34fcc32381a6824315,python,34,20,14,14
NB_944bf28921c57a1420cd9eb3dfce547cb4223da67eb09cd084db886dc6f27b18,python,5,3,2,2
NB_8781116f6614a65f60815e587592784ef0085d5c4c020d77108e207f849ea870,python,30,14,16,78
NB_a1a680328f5a266e9819b0727a23d08aa9b9812e99d327cf8eabf4d57aac979e,python,3,1,2,119
NB_eca02cbf5134ec73c26c8d8283d89a5509e91f4b4899fa1f779fba37921f03fb,others,77,44,33,33
NB_59a5464ef6213bab480026f23b22f7546e80705f6ee8121fdeb0d2c41706a609,python,14,8,6,11
NB_f910046253d8b9ced076b868b8200dfcba54afb3e6c47fc8ffce0256a9cf9e38,python,31,15,16,16
NB_4b1dea5de197dde6d110525a4b7cb49463f43c7bec68cf55822e213371e0cd5d,python,17,9,8,8
NB_3a840de85de88b218070668ea69ff1df8499eab3b9dd18550c12dc6e4cac321f,python,15,6,9,51
NB_22e8e63aadabf9e52269d86c901156bf48c88e4ff0667f75648280611fc1835a,python,34,14,20,88
NB_36bbdba7260cc6e8e59fd9fb133005ca703eef60fdc2e2bdbd2b729543f6e3aa,python,13,7,6,31
NB_b7a1474a882843c89f1cbe4c5cde702b253bad2a4dd71b1e42463c780bf0a07d,python,7,4,3,19
NB_d075760af851ffae989aec30efc0a864293fdf4f98eb9a2359180ecf1591fdb1,python,12,12,0,0
NB_781d02d04b87fe0229f0a0d43ea5253feb2540114f9ca8cf8074cf646b730c03,python,117,55,62,121
NB_d283e11dcb8630d58ed15e85158a5c7823a747c33977abe9a85a9292eeb787ee,python,17,12,5,5
NB_69261e123358ab398fe37802c6929f25675d381a379f8f98a4e030a392849849,python,67,35,32,100
NB_ecd8ef27867b2ef8f8f983b0854990e36d9059581ea8258ca8e8b21bb7e39ccf,python,139,119,20,20
NB_bc494756fc8b3aa2f89ff7f70ea484f985e5114b1d4e57b0fb043669965033ef,python,3,2,1,13
NB_6db3b9f0bb9b93ba3e9c9da2dab157fd319811bda8540485ba93ee2a9e68b1cb,python,4,4,0,0
NB_8eb739ebd4684e57db834db86862e934f7203caae83b07d359b621d0e497bf37,R,10,5,5,8
NB_a9ba7de9bbe6753e2f3d9a14ea0b24140377c85d6f5dc177626673f9497c709d,python,18,12,6,17
NB_210403aff1ad71d55519b157218aa3b9abe9cca08a8149740a2767a0c2d318a7,python,13,9,4,25
NB_ed2d14e091f9df87855fc53d665b6658db5f6d1e7cfe6b9bbbca3fbb64d4f46b,python,64,52,12,21
NB_fe18f031424eafbab2387c57a3caaa7a97ce7efb495662ba90219c8e8b2cc2ce,python,40,33,7,7
NB_dd7b3a53c92ace9ca4f4f214db7e3faa35ce3309413639f9bea8b0938710b235,python,30,30,0,0
NB_329c4c43585ac3fedd61f5c4dd7b4d02e702c46b8166b9ba2e44ddd6d492192c,python,15,12,3,3
NB_11b788324b194d6fdb93987a1d93525adb4d829dd4ca0d4289c863e8fd4e2e85,python,8,7,1,5
NB_a3bcac137a449cd65c198328c04ea60ab08de283526d96879e95676a35aa6818,python,30,12,18,140
NB_945fb8e2a5d276bbf0bbd4a94cb70650d7110c6eee356ab0c0aa559bbd891388,python,83,55,28,71
NB_fd73695dbed31e53cf5f593f7d3af880641c6e36a50b1aa0d377da44a328c3b5,python,42,17,25,183
NB_04286a532f0da129f9e412f9b4df30a7150d7af3753c7bde2a4d9ef201512c1a,python,18,18,0,0
NB_65fa43c069fc8abfcc9940304e339f95796f3054c6b26baadc120199c8180d9c,python,6,6,0,0
NB_ba89b73e6026d954125518fc4575cae647a92b830b4c9c59edcc8b6795c0aa16,python,20,17,3,22
NB_19700e5fc2239c49eccea6e457c7db18456e601acd2ffd40e997d65df7a31afd,python,36,28,8,9
NB_030eb8bc56a7ab1736b5ed9b00177655fe101ecffa4e9c154d8766f8905dbe5b,python,77,54,23,23
NB_69e4e6c2e5eb537a5c7ef9b81d88ba7bb978a03f40cde13b677ad43b8fe58ce9,python,2,1,1,1
NB_f759c524d9986c174679676e5e8f9730771b4f5d462ecbfd25417dc6c9d2d100,python,53,17,36,474
NB_4c7e889276567a9bb974922cd09887d956a851736928f8e97a0bd1db0bee8863,python,40,29,11,18
NB_2fa1bf3ca9a3a6f4359bda60682877d5eec0dd8b5ce5807833748eeba675dc06,others,33,20,13,23
NB_b42f0a5c80dff1621b3ca01d38bf9ca9fa0885ba8e6ffb382aff045f65eab6ae,python,49,22,27,316
NB_9170758e9e65a1e52fc21be8c6c4a3cbdcfdd78359e1235e1000c192fd375259,python,18,8,10,100
NB_f1f205d99eec80fe1bcdb580ff389f498e2c74534d55f4a1ec0aec6c2d573b82,python,42,30,12,14
NB_72219ce2b1ce8d2cd1c3cfb3b9eccf32c8eb77eab12b3e6fab354ac970106e7b,python,9,9,0,0
NB_eaca41a99f49bf7485e8dde6710a64d17954654752346e7df84df1432796e846,python,19,15,4,18
NB_fe308ef2e32c7d13c5686a2fc2db25e65d4dc453cd36f3ea54e6ab84f695dd4c,python,4,1,3,204
NB_4826d8cb5e78c2a53c1ad84ffaee8a60b7558bf3374c1520bd56fa724cd5f598,python,11,11,0,0
NB_3d299c4f441c94e021dc6f8c10e1b2293e32546e7dc2948b8abc82053ffad1e8,python,23,22,1,1
NB_99e44375919a1e06b9a217d51c2be77056d6e9be004c1a36a61386c89eb54430,python,47,23,24,91
NB_d7501521e2729739cfba85a671582daf2a915a4d7e8b8e397ef80a5a66c36f20,python,24,24,0,0
NB_6ff2e89c18a39d397238ae2a5ae4f7f0bb9c55d915b5d4c418fa483ce915bf18,python,7,4,3,3
NB_cc6d5ab26b9320f84e62f2a33d34d1b0848fc103a4b1c8deed589cc1354823ba,python,233,209,24,24
NB_7867cc01dcceeae8db8452e807ad8f2bbb5c4651b027465ebdac10c8016de1aa,python,35,35,0,0
NB_4e7530c187c99db7d759fb2b68336ec63ffdb8a2706edef9897a888f73b52aeb,python,74,28,46,387
NB_20bfe6c2316c2bfa660929ddf5ab65977307fe6a8e029ad99225c3a706616f15,python,29,15,14,35
NB_eb4fa00095a3107db1e1cb6095f5790c05bcec57b7533c46089c657d1039485a,python,35,26,9,23
NB_431d3ddb7ea77d9a149ddfe568582ea36d2ec2ca1dfa49b04a70725021a79297,python,47,20,27,120
NB_356a42dda33a44c314cf0ad126ef485f56a32535390f2c2a884fa5a8c6896c50,python,9,9,0,0
NB_2b35bae753019f1b901bec5c494d1846b06e49d053b09e1f089346329a9edce6,python,34,34,0,0
NB_9d2249d8ba50a48d8f2dbde529018f170a6d94132d286d5db16f561b856be823,python,51,50,1,16
NB_2a1bcf3cec353c41d2c09ce1fde027a1858a41cf113acb90327fb8bcae3b4be3,python,16,16,0,0
NB_1d59af86206644d45e8b30f905b806feb255a0052a1f557716fcff59569bef7b,python,260,166,94,218
NB_4450cc899b1c8d238fc49136b1852c4e630b8437811df9677067baafd314664d,python,11,5,6,56
NB_b049d5cfa44a0aa8c0232e76ae8871e20a4879ca9e674e16ee2efb5241339b9c,python,36,32,4,8
NB_115d1496e257d9e9eef53944f7a6134faebc80dec0df1758aab9d26fa3774c7e,python,4,4,0,0
NB_74b5222333b0c564e11776e5b7ffdcd20042bec5109a23009fd19f812f949e1b,python,34,22,12,97
NB_5db2438d1cd5441e85787bc36cd1bde64b43a9255079f6e46d5b8287139b781b,python,92,51,41,132
NB_587fa56d0c3d7859b29f232d7c2f5f4394000a87c886bb0089d23f64003612ef,python,12,6,6,24
NB_fca74c6bf31fb8582a30d2cd8267b8ae52c003fa45e626dd1fb9b765a57554a5,python,12,12,0,0
NB_36d634ce4d5590e1a420dde3a63e5b0adb859d091479bdc7a797faa9fde4e76b,python,8,7,1,5
NB_43f75c0c1ff050ba1b41c2596027323ee912847663d2849a02110006a80ad887,python,68,53,15,15
NB_3fdf4e2fe77ad4331990fd6b5e1c76a88d6e4225a46c09e50a894818409962a8,python,53,27,26,31
NB_09ccf833fa51d4defe468453bcbc50e2d1dd9b725da8dbc5c94937d3963c5134,python,18,9,9,17
NB_68955f2d783574cad03134d47138f98e88e86741ee4af22c4102fa628a25362a,python,39,8,31,100
NB_b0512b88cb2d2b6f5db86b7ca185ed026bc9074838530ff73c11e64690425e52,python,9,9,0,0
NB_a9685080591090826413440f96d9154f43753b0ebb64128563c00fa1e022f99b,python,82,31,51,199
NB_75fa93b5b0686cc7cb99bb26d4b082e635fc9ca4017f48995d836b817ddcf54c,python,25,25,0,0
NB_0881509e65e5d9e96b409e92f958cc1ba6adb7dfcd8626ffb312759c5e31ac46,python,8,4,4,4
NB_dffbdba0c556d3c857d4bc23cadbebdf303317b573dc33ba885473fed164039e,others,69,36,33,39
NB_c4edc01f8f5a7849322f39ea37ad4e79758b46c206618a6edcfe4d9c968b0e93,python,2,2,0,0
NB_d8c6349fc1e7d31c36f3948d5e0061ab3b49c0f1a596452fba2c764eddbd44fe,python,7,7,0,0
NB_22361e1ed5dcb114d7806834ebb09e899d86cbdfaf0dcdaf3e26d3ffe1c89e5a,python,19,19,0,0
NB_0ba4f243e850a2497711a571f5f913e2733377fd1adec0fb7cb03a45a5832eb0,python,5,5,0,0
NB_afa2f778df5658a3cd0968597fdf87156c071d38fe62ed3d5b87e60b319d2053,python,43,42,1,1
NB_ecb105815b46eabb30606b5393a93dcb4baeddf84db33810940b4d1d6944db04,python,17,17,0,0
NB_7999934f652634d583c60637f36784982c1a824cca0dbe2607a13a8ff3d0233f,others,94,55,39,44
NB_01eed3cce4ad61df89006c7f5d11561d0805047907339dfba8753c1e9cf6785e,python,20,9,11,155
NB_9da5c95b92186cb1fa660f586d72244bbbfbbeaa07b5f11be44220bd9b0706b8,python,20,9,11,103
NB_de060bbe0bae5f9cc3af96e42a982438a6200fb2674cb9ad5e71b4b6aae2a2b6,python,11,11,0,0
NB_9be628304af7df98b4220befb7d08072b88e894921e8caffefeea856e1e2677c,python,29,29,0,0
NB_20d552677ccd4b0d32b5b0d68f9b7ad7fae4a125084cd52d54d9dea9fb1398d4,python,45,18,27,223
NB_ea0467db19146f8acb4e9207f38e9ec61d84054f67b80cc495a76ac81d85178f,R,72,26,46,46
NB_6383c2b5a2abd72fda780dc48646e388a0dda9e4f23e94da42c43eb74fa426e5,python,26,11,15,26
NB_0cec5e94417eb3ee4078ccce90a9d7bd3aa6f77b0af930288e04b2889900ea2b,python,59,51,8,19
NB_7f3c79de78f6319f9cda15c4469aa95bc8104c5fcfe903a4f059828b14586dc9,python,10,10,0,0
NB_de1fe6eedbded6279b422411a643890bcfffa6dde9a1f5b0746fbaff77611965,python,24,16,8,18
NB_10e321cde551c0005c12de6481c651a500ed16f4e57a240a0b82a23753cdfe1b,python,3,3,0,0
NB_d54e1b300985809f466aa13a08963559fe0fed31d7c8ba95e860ac482455c22b,python,20,9,11,91
NB_b17d34d94f63c8cbc443fe41dfad418cac228c19be7300ca1eb8275c1f84c28f,python,4,4,0,0
NB_9ec475186b53fb95fbe1deea5d2d4d9d46c2fe2555c410170befbe9141288ebc,python,24,12,12,54
NB_2d0e85c234b6077cfe82a131d2e87d2d1abda8bff58a2c6e3a64576da28baebf,others,52,30,22,23
NB_de6a7866c43bad5efcade2133edbd4c932ac44e7c7188933f0a25ca40f9c0801,python,26,13,13,103
NB_d27b777d9ba6db5d6024e4401fcded047e0d0cee49d298ed9ca0c1a84d12dacc,python,114,109,5,42
NB_162005ac684f267d677b5b2e0dba2da1acb21ef9c51152e93eb2bc7d402e5c48,python,30,26,4,14
NB_71f80108b86dc112f171b5e9ebcd3ec8b150260fcc5bbfd3f99ac0b84b5307a3,python,13,7,6,48
NB_f0f2c68938b7b9d77a294226e29b649857f7cc18e579582a7f37854a59327862,python,7,7,0,0
NB_650ed01dda1cd84ad68f28b189eab05001872468203dc9ab3a1addf48e0376a0,python,39,22,17,29
NB_842d1906789698be042684234129b57b80705278f75e7b39f99430ca1d3ea226,python,24,12,12,122
NB_ec3b4279af93ace927ca70eaf616d37eba27dd2c88c600d7544df3f5bcb20d0a,python,84,46,38,51
NB_6bbcdab1bfe9ba0d1d7d1ef6cfc5fe4dcd303eb6cd25c2c340e2d1caff2f3c2b,python,44,17,27,279
NB_d033ba3d7e74e9e978d9b92769b951ef57ab3ae8cbd4e088b3d45d31637f9272,python,14,13,1,1
NB_b2ae15e659cfe9fe4fd21e9cfa3e736e18b4ae6f23ce5b35909381046ad32dc0,python,42,30,12,14
NB_4a9bf7c2675679a683d676c4edef94d421f4ff6e37a374be3a4edb718df2069b,python,10,10,0,0
NB_cc5e0bd887a20c7aba61466bac5ed47fcc3c115c1a5c7a219868565ff8f4a6d2,python,21,21,0,0
NB_6b4fb529f529f082c5473fdbf4755a780dd9aac50d01b47afd145de135cb15a3,python,7,7,0,0
NB_6db8ee06d213612ca134fb4e7dfbcf7a135fa77bceb4a96e487ffa4c35124f56,R,69,33,36,43
NB_9f96401f86b099edd1904f31d6d275eb3badbf8038743e4c5d08df478313abe4,python,59,39,20,48
NB_d66c1e900f9eb6a56a1524800c6562677be60f145ed2ca0c0b2254d463f73c5b,python,24,24,0,0
NB_3674cc8d88039f7f4ff032db0584859c8a293b229b8884f57a7767563a79ef00,python,24,24,0,0
NB_dee0b13af789e6450a85d4e04037b0cab21dad6c50dbf240041a6cb3792765b9,python,4,4,0,0
NB_dbd116ff91c6c5e515c4131c1421a315fb37cb823d10aefca505f6dce520d105,python,17,17,0,0
NB_2dbd23434e319d630e415f477c794cc67a1763f3011b5ee4ef90bbea6a643a5d,python,35,23,12,12
NB_a054a2dc12d8674d5aade3caddb2f34498f8874756ee269476921eaafcfca2c1,python,99,89,10,11
NB_5dffb64adcda733f2c49d593fff62f51ed656a7d553f29c011b691659c8da594,python,9,9,0,0
NB_161b096e3931866745fff977321c6b83a2c9db6f73d7ca34881dd0c5ea7eafa1,python,26,16,10,46
NB_115aa62c9b040d4e449ca06a04a13d6ee20067e6595e282b1426d87ebc653c73,python,18,13,5,172
NB_a60a49f6ba57499142c3d4e947cda6a636c321dc5649eabb0b2d14151f2577bd,python,32,13,19,131
NB_d995c6c14f3bedb42c366d255cde5865700413a6c2537079b549f096c7990087,python,28,12,16,187
NB_d0e86f4d1432be685aed04e8206ff159a269ab0a41c9ca4221ab1a71d6621dd5,python,123,98,25,89
NB_9d6a0725418eafdc07f2f9a0a811633fb2cf1e4824f3c87c5f5ee43d474baecd,python,8,8,0,0
NB_ece983fa03dcefc5f3e7f9635296ed9eff7959de2032208fc4397659bd02d0d8,python,8,7,1,3
NB_13c8fc0828e5353ff00ffa434f7a5338d6cc3564de253f5c85b6201a33517320,python,4,4,0,0
NB_e1a377558117cd485106ac90682e4e66f26c0804b389b287f4c83ad5ddca27e7,python,90,39,51,85
NB_7d3e0a654ef15c623ee6aeffa7b5f32b4fac0f7385f3d7cb8ac6d5bda24b6f89,R,93,41,52,59
NB_b66adead6862a206275819fd9ea839a7f4a5fb5a362eef89ad8fab2786445382,python,6,6,0,0
NB_5da48241bf47c919b0527f4e9cc9627f89bf93b00919029a2ed1b68f5b3b7264,python,41,19,22,74
NB_4e2469f3ad371d0503b8288af93e2108cdc38ee91490cb31f509ad60d58d06a4,python,6,5,1,16
NB_409dedb61d43e76ba9443b90ebe88745c8135b15157b31206ff37b56d5fb978d,python,11,7,4,4
NB_9c5b01fea5bea4777e2df4e813a81b89bb86ab7c2630e89a7e13a171073228e7,python,9,8,1,9
NB_39fc6ccdb8108504a42ae072f98d299d46309358c125cc6e450898ea0f913b82,others,39,32,7,15
NB_2d5623facc7691f5d19574cb9572a6f796818b3f01e80f1e18f6eaf75872e151,python,25,24,1,2
NB_c0b21817d91571ad6009ceac977a8c0230d703c474c6e78393d576b47ff36709,python,55,47,8,8
NB_389492005543f9bfe4a53061c14b5c502994c532de4df047bb9932f5e2e383d7,python,12,6,6,24
NB_0f51c6fb2466ca40639a45b378e2d3243ae2714618dd41b5003dc11bbb1a7427,python,27,18,9,15
NB_e187489edff59cea98de531817a390f7af3fe940c4c79f7f64cf1cbe83d682e6,python,1,0,1,25
NB_5011f5987c8838732cac28d95085eeb0d7b767553c5af20816e2fcbd0d150fd2,python,57,45,12,22
NB_aa5b587e70f920a92320093fb4b2feec1447dfa5af195bf9d6e888f97d4712bb,python,61,21,40,175
NB_58fb0159086fd3ca2dd10ece9a71448194999ebe3153e56f6745d4e742ce94eb,python,7,7,0,0
NB_b0f14923947385dd5f1720e9e97b79d1d722da734e1a2c38272da962a42edb6e,python,6,6,0,0
NB_88300e7a71c71d76ef7d133d370c618a9dd13e912ee2163d04b3039aabe9df8d,python,66,26,40,450
NB_64ac9b02ec23cdac367c21cae27cfc8bd52c5e16820b70c73c307ff81b866686,python,46,22,24,97
NB_eb9a55c789c3ee498bb01386505a2516741dfd887306fec8d0b49c0eb5d9a37d,others,24,23,1,1
NB_b98444df455686b6003c5707fd8cf2a38d6a908ad0a5f6aa1e5ce3b2625bb9bd,python,20,12,8,10
NB_643d019d5108af6b7ed4605c41389d3fb1ed327974202a71457d577acc9583ef,R,45,23,22,23
NB_c19b6ef5686a157622bcf5ad56eba9cf8aa841c3e70d192b3dc85c67bafa7840,python,64,45,19,21
NB_0b453d60f8a7cd6701eac34df3bef4a7c67c06fe8c5fc73d28fefc3a45e76b39,python,1,0,1,116
NB_53cddecfa529de9717f9e45cfb2557e3bd4b4fd7c290031e0fedc6ff3869a3d8,python,8,8,0,0
NB_fdf46488a31b5810c12fbd52450929d927bcdc31f9dd951a332939efe0660743,python,11,9,2,2
NB_1dbf84140dfd2b218c5407f8558eaa8c29b91b232aa75989f16df216572cdd83,python,39,38,1,14
NB_df91f56a5ace652e75e71613259227ebca540193d6ab999bb1fbd1c62146120c,python,22,10,12,153
NB_5018d2a2598ba845f74ae3b3161e88044f862eb745111b5fa3aa3c58b02c9b95,python,62,46,16,16
NB_a815c59ff3097a228ff75de911ae8345b53a6639ed5e40d0777d424e055bf338,python,66,57,9,9
NB_258578b31ed634faa654997916f8d4e97ea9fbd403b9492d5203a17bd0eecc46,others,84,57,27,362
NB_30c14487756603e203a90be6e32a01628b388aa738bffda1a70c234b9bd99c3c,python,16,12,4,20
NB_1b85a27d84413eadbfd85ec30423323d670a2acf8ed554510cf290f1ef782bd1,python,39,35,4,4
NB_b7b8b324dae3a8fed53c04cbbf9b25549e9b611d79b364a3ac3fbe7954c65411,python,30,16,14,337
NB_97686291c121430f2bd342368c94f5bbd2d25e24ebf25eb9baeec4b8fc5c9d43,python,35,35,0,0
NB_cc1c08b55a2c47887cec3eb7119ecc621ce51496bbfbfcca4ab24a136ded0610,python,43,34,9,9
NB_48405b91575c956562a6a29d550704660374938c275a033b4a160bbc4cc9d6c0,python,15,13,2,24
NB_acc3d2ab19a76453bc4dc5e66469cc5d1cf02628aa1e88b8abbbb5a9d89be8b6,python,21,16,5,9
NB_015e73f12eea841a14d69a7eacae9e5807df3ca48b7af4e435043de5da9623f0,python,17,9,8,15
NB_d4ea36a043beb6cdd06880a01f46aaa124bf38fd7975c1f1d2f142e14b8e38e8,python,19,10,9,80
NB_1bbf621de62b1cd63a3d4278a0851772961d681d1986b2c7b6c403eb5ab51aa0,python,73,36,37,548
NB_37e1575bb17f613da00e075b6bbcd6b5dced1889d01362903e57ec2b1d84edc8,python,6,6,0,0
NB_f2750f1e036ca6bd53a4732044f1aaf864065e2b0b53de15f0f113126995d87d,python,3,3,0,0
NB_309fa813e668da371495eb9e415c0f0dc85108f228ff06e326feaa1c15d406ba,python,8,8,0,0
NB_697bd197b4e742fb17435a4260ffc71014e200d2cf58917c7f738244d6023d26,python,35,34,1,1
NB_0134ab42ae09bed2ab36ef15a1b47407ce80de0a390796e9a6259e9f8e590463,python,30,29,1,1
NB_017e8823cef4ef1d8607b596c5bb2d8e401ec8e5e0f4ab210a2c439b2f43567b,python,24,17,7,7
NB_d6ad7be12f642bd02e8dde50dae27f2aaf5c7b77dedaf4cde5ef6c32064bc2d2,python,72,27,45,175
NB_7cd82f0ec5f47e48de2af81912e45dc2488273a3d8a0c0a8d336e9a79ca8ff9d,python,20,17,3,3
NB_364a7b97f4fbee30d8b2f513065652a204c3b79f035d76d1f0226e6b4d0b6dc8,python,44,19,25,91
NB_149450b9cfd807289fd41b0610265e5d3962fabf4ef4f007b394adf7f6692b21,python,30,18,12,198
NB_5021f6a6051c4b5d74fd0038e20e0817e96004a481d6c1f7e3e4564197e3702d,python,70,58,12,69
NB_fe6d1e24bef68f1afc92fab98312cf6e7f61564891c4077c99cfbe9f45b43956,others,27,26,1,1
NB_099068912c79612c6fa67c5d3a4cd4115690e3d47aba51213bf5330b85a329a7,python,145,86,59,89
NB_25fc40e8c6c9c5b6246dea26ca26dc4d18e727183d5f86fb83b2f7224c29920c,others,94,55,39,44
NB_540e2ed7c4e4cc8f812ed29498883d1e6cd9b01799a4cb7ab321c28f4c516b7b,python,31,30,1,0
NB_d26cea173648a6be2617cbf49f048b84c668455287b6ea26c90c9cbeff44c00a,python,43,30,13,321
NB_8b495ceb37e84498919eb7806a97b0bb1cbbe44086ce6d0c74b37ed7d7b57153,python,10,10,0,0
NB_7be1bad53d555057feb6211118328693c8a55d3389204ec5351a59affa49fac8,python,69,43,26,26
NB_dc3d834f0d038ccbcd8c2f03271d4445d7499d33d7dde7f88f689a0c79e595b3,python,50,50,0,0
NB_9e14c5150570424558155cdc88a70f310bbd38e7334da024f959b38e3e8a3a10,python,35,26,9,23
NB_ba188eb1d91b557d68df98eee68d33794ec2c7a3d9d2cca6af3f317903657df5,others,0,0,0,0
NB_bf87905dc5164a734fe2c5b3f05d4e84c0cbbe522d74baec69f299a458016a58,python,329,269,60,69
NB_27d99f1b025c8ff74a2c10165868643072509b14ffeabc2d8c515d974b175048,others,31,19,12,40
NB_5ec27544540688de9dd4f32774141e49b600bc396f0403b8559ec216117ee321,others,12,11,1,18
NB_6f65df2ccd3aa704c0cafccd69e51a8b95a52c445158fe6b8e0a88beabcc7dce,python,37,23,14,14
NB_17d44495a29ff5ba27b6aac862039e7f15732982f72e2f87ac05d75dcfd3287d,python,67,55,12,46
NB_e3d879dd5e2e7345429cfbfa685627739b720601ab01966ff47541537594d1ae,python,6,6,0,0
NB_d9bf6cf38a5ffaea6a65b6f878fa5e14d69c38cbefa7005efcae21ef21d0f3b0,python,35,17,18,24
NB_d5b6ac2b61b60364b190ea50f33f5b416b22041b03ec505dd19295b8bc77264f,python,34,31,3,3
NB_a16ba0b57a472411cc8ecbf2b8336cc2be878916dcf207c5274925031cd785fd,python,11,6,5,13
NB_5341174c2e92256753b4e20a99025f13e45ba207570d965a98bbc7f735022867,python,3,3,0,0
NB_651f40fe7ff11ad1b008310cba4c05ed667da62fe79852334686166b5f2a882b,python,2,1,1,12
NB_7990c18b76d5b7dcbb3bb27d70b3e2ac2fc4d7e7ad2572cb956fa0dfa440158f,python,23,12,11,65
NB_3f1481c4c7b79d577b442f6bf11d3f785df8f1d0b88137fb2d8f841a5be08f33,python,69,29,40,287
NB_aa4f2b6a94252d8153f0c73a8e83a9ee7698f0f0509c934e25461137a6188e28,others,109,86,23,40
NB_7bd532d6e7a93ce4ebe4d7446105979d6dbbc4842238bfdd1274580306d3ac34,python,6,6,0,0
NB_08935f8a3ba1b27905b2a1f3edf614c8dfbf32af47dfc0140a3f34d384e01813,python,24,23,1,18
NB_4bc1c678fe1360be3fdea56903791bc884744d85c9bf481fbe394190a8978534,python,16,12,4,4
NB_c1510dadc86d7d8d36ea886ef7cd6b0318f9d3faf102c9540a1a8fdc0eaaaf5c,python,110,87,23,82
NB_22b5974f9b2b34f9793932e53d6b7fac0accf0b9499cef8407387ed755267242,python,7,6,1,1
NB_bf21ae4cbf720331680b690dc5317b1ba8f651b3e962f60399a509b1b6fc2ee0,others,18,17,1,1
NB_5a9f73716696e29f70e23058c931d286d2ef5251411ffb10c8b82f9754a4a81c,python,99,2,97,357
NB_86df1389cce6ff73a7b353cb3c28ecfba08bae89b71cb32004f9611b26d7764a,others,52,20,32,178
NB_1c1f6bd4e9dbde0912bc54990fadf1182cc7bd688512444ed435ac693a29d5f1,others,0,0,0,0
NB_2e59fd5b9073053e2683aa615d8da2dd796a672be467d12dbae2fd3e88a6fa66,python,24,24,0,0
NB_3c66efd5e2e889785475c8881611b0c46fe00790565660c6e3001bf3dfc39185,others,4,3,1,1
NB_9e8dd0e53b275a7ae4c840ba3f9128ab5411dcd5213cd5f9a886d056863641b5,python,38,24,14,125
NB_873fef1e5421887cee89cff495fed7f4e15e834e966c73fd7aed734b4f4bbf8f,python,26,25,1,1
NB_5c4cf25f6abca7d4d73ddceb4684fa9182bbc525afac77427e2f8143f92c0b20,python,5,5,0,0
NB_8aab30960268e0bd1fece165fcee5682a9bb92f2dc5019a16a33a6dc811455ed,python,6,5,1,6
NB_d816bbf37eeb0d5de8a6ab5b2052a18eda255eeae26553f75bd7d84316f2de20,python,26,11,15,266
NB_3b7333c5ef64d75aad04d3445c00ac7da052bbc680751c7c2b15124a3a933755,others,0,0,0,0
NB_88e9d7cdc0c652bef001f747b91907a9daa610fd5b3513a72168ae548bb03474,python,40,40,0,0
NB_4834c77603b9978935e0999ffff9fdd8563970ff57c302b060a308b43384051b,python,63,41,22,25
NB_aa54fbde669e961b8151edee26b5321e01221325b2dac4673551d4877e8e352c,python,29,23,6,26
NB_b121e78ee4b6030cdcb460c3ceb2294b2e732a4764f8a13e1df2754ead85518d,python,10,10,0,0
NB_c6b2fb93d00e03cf97603546937df1a401d9174d3d4371d5c20596474bf6288b,python,12,12,0,0
NB_f5b66bdf283f9e5e5a5458ce43318a7cdfb11e7919d7acd29f228a439e680fc1,python,27,12,15,48
NB_28d64514dc3533e276970505101af7212e525cf6566633ab5c2f367e5cbe087c,python,10,10,0,0
NB_f252b1aefc72ee0dd276d45a203c80890a76beb072d6132d267abdf2b1627c1c,python,6,6,0,0
NB_d8a3d05dc087d52467dfd3fbfede55bef3b418a9b99f9f7b0c0a44adae458eee,python,5,5,0,0
NB_61473c33efd551ba2d68f2be3add821706049b6a80e4f9876eee7d3b23076ebe,python,47,26,21,272
NB_b1ec557fff48c9e57b5371a651c3fd7c1be8de72a24bd0b5a92b54d93614b945,others,15,15,0,0
NB_34409722b3bdd28beafd8f843ac108f4ca81b28ffb691ccf2706b96b5a743275,python,22,9,13,23
NB_deede9d2724911f4f3891c2bce6f411270630a48d20ae02dcc4250a74f4a7c66,python,16,9,7,72
NB_9d64350cf24156ead4c8e2c0e35d8d02c6edadb345ae4bd03807316395ae35dc,python,25,11,14,178
NB_c441436dae76d735c82c0097e2922364727f3240a58875e71d5d43e842eb1d94,python,57,23,34,292
NB_86d66be8004a258dc24d48ea45f62b494bd523ed87d980306c08776dbc32504a,python,35,23,12,180
NB_21ce6e1e968e476c0c84ae039e0928843ab1c065d12ae1471260ced8aa5cff41,python,29,14,15,60
NB_a79ca88ad1281038ec30346c0cc8dd5788ebdabdaf846206df8e9a0c0e3304d6,python,329,197,132,227
NB_e819588c2d6a348dcb7821d96cde0463976a57fe2791b749310f60f0f8aeaebf,python,13,13,0,0
NB_a3041ebac6cde1a9e1a4a5310d70a1a93cc32cb7a4bdaf3a98d3e8955ec783a0,others,121,75,46,172
NB_803a9c89f8f829e2d925340339e951fa23e36adb92120586005a5fda6b126543,python,60,38,22,50
NB_026e0a970dbd09fd4f15d137c5b721625ea1337c53733b689f35f46ffe28cb18,python,26,21,5,6
NB_30e14938d0977227ae86d0971426fc00cdd0b037733663d6c7703c4e5ba69255,python,30,19,11,76
NB_a72a19dbea8eb44357c16a09a55a1bbe32d3218ce2cf26094ec9fe1b210f6ce6,python,8,8,0,0
NB_61e0fb67ef2fec1fed677f4fb51403246ff25d7e476fa9e49120571dabec1a19,python,240,113,127,1767
NB_475a555db5fc0bc8d760e6eea914e2779501409d87e60b7cae9b926cb9547aa2,python,50,16,34,213
NB_5f4007db76d53fecdd4c43b965c9efbdace83010d9b3d62c1d2c9c32d41f8b76,python,207,152,55,75
NB_39c31df0de51c3d152f358fa29ba1da161c017adc09194125dcd958c38b446bb,python,25,12,13,59
NB_7daffa8f47d51818c0d33bdcf0f5385e209b50e865e2a06de02a3b8b3ba34d22,others,27,25,2,2
NB_105fa228a8b717c0090e830685e9499ddc864a2cc2b27c716ca0571c7a227f52,python,4,4,0,0
NB_0dfda15bba16893a824d376a526713d8e45b69f2cb40775c85b2ed57a3c65853,others,5,4,1,1
NB_daa4d5bc3ab498fecb960a696d241174ddd3d1d301bfa73807642980fa7329eb,python,149,92,57,129
NB_b32d5cd8900c008626f796291f70870030289c0e8dc7017f95886298afd24add,python,12,12,0,0
NB_9d68fb59bc5106c8637229eae828b11c1b0a22798cc3bcdcc3370f6528515923,python,14,13,1,1
NB_dc4370e837bb76b9c3d540f4333a1a32f539fcefdfbe4fa99eec364f3094b78b,python,26,20,6,8
NB_5943c31a3bb3c2a1d2808e045ef356d4c8da4171088dcdf063bb7fe045321060,python,11,7,4,4
NB_c62af69ad27ad101cccca8119ff01dbf40628527081f004e7087b65d0f677e32,others,29,14,15,87
NB_aa13613009e4535fd983a7181e2433e9cabdb27f994264e938135bf1fc213826,python,68,29,39,417
NB_bb4bc0b1ac3bb8b5dcda7ea3159e4bb40761f38f91288c1b92787f90eb3f00d1,python,12,6,6,98
NB_9db498fe455d10de1a1df631d6006d8f4f0f9fe72c6d865e2351e227c56f28e6,python,22,11,11,33
NB_0d2976de1c8b0b6fae944920cc68e0fc6e5d230f4197bb456ea916aa04fef837,python,62,46,16,16
NB_c1dd7ef5cb92fbe5cec0a1fda2c532e385cf13b0559c9a6e6e2e4e5bd14da40d,python,64,44,20,36
NB_a80f8eb547e941a8bdbccee748f137dbc875d734ee6e68ed6eeb10eabfc96840,others,41,33,8,19
NB_a4217925acf6380216312800a32aa3b282abcaba55e5bba5fadbb845548ae912,python,36,36,0,0
NB_7c64519bbd4ab33389d0eaead81b02cd6c9688b85c5ac8392afd85c0522cd847,python,43,25,18,30
NB_8f50df6c740ecbb3f69cb2f68179edd30a97fe53cbd59537f3ecfd0fb5aafa30,python,138,90,48,78
NB_01ad67585377ea09cf87b6bbb0113caccb67c5e12e5c360e62c39829f116f9ae,python,42,16,26,248
NB_9be19d3a5058e1d39148c75c187b5a1e09c35f01e444671a139470788ab50f99,python,45,27,18,182
NB_0b041a829f1c6798e231468bf61c811244efff895a1f7829ecc4c43b5bc9bf45,python,43,35,8,11
NB_c393eea1eb1ca3dceb12164d73c3e364c93ae87b48c9dbe519a1a735d459d725,python,12,7,5,56
NB_4c3fa54dc711ebc3fcd87c5302c3da8e429ea453f2c04b509859a7f7855dc2ac,python,28,15,13,156
NB_ba1ec28e53f66d03cff675e2a880a294a821c89f55efc55cfe25942a52877073,python,29,21,8,8
NB_bf090a43b8a50fa2d36d39fe44c9b932c684ade9702a33398487866449b8fd6d,python,16,15,1,1
NB_92431ff24153a34f79bcb13fb38b8837a3a25649961a75c097f806d24d85f209,python,14,7,7,35
NB_e24a5e62f312d635225bf2752ff61fef1ab646c4d9fb2177e3c6a6c3c9f600b9,python,10,10,0,0
NB_5649c33101c377de916d9363155f1fc237671441e1c63c7a523b5baea26d2ded,python,14,14,0,0
NB_3bc61aca23fabd80d6eaee09f9bbcecb2516ab42bde186ed47667fddd45ba0a5,python,32,18,14,14
NB_ceff37dded738e1400a7f512f20fd5e25c9c81bc116a63585d957902c156af85,python,15,15,0,0
NB_ee66d44f9714e4eda0ffc3d6456d9249a3315623f8d118dd5a6e3c709df25182,python,34,29,5,7
NB_075ecf43e0f37760948a3101e5abf0173eb85661337a81e23316f8e83b022fd5,python,16,16,0,0
NB_ac1f8ee600cb84f64cba2203f780b3a61cba8ec9c1e8f1fe08497fe9f2b2ef31,python,40,35,5,5
NB_5bcf1c890d8bb485e44cfa642ed585c79cf3c843afce8b0523771d869a7fcd60,others,32,27,5,5
NB_228484e235a5a61c4954c6752a905f9ce16ba201260e9e4d9244d83e78b97e4c,others,55,25,30,171
NB_136f15305d93c86b8c73d47886f152a30b19dc53d617bf307ff679b67b426428,R,97,40,57,58
NB_a06e8125cd2dd0a141f83400dea59f179aeed62e4c13f3f87cb3c4ec6302dfe5,python,7,7,0,0
NB_f17cdc14afa9873917b35f1118df2fd0e70a39c3895d157df931468527993190,python,12,12,0,0
NB_749d9c3e48aba7c30131e7b9ddef06e7f826c6d2400d66ff65a0659d8d231a28,python,7,7,0,0
NB_739b272e388d4ed21829060c97861dc6ba2fc7f27eb67bc82805ca8071c481a4,python,19,14,5,5
NB_5aa021da6c44f6ae9029a2ad97e6e22aa009f1fd2b933eb5555a4c9cdd7fd2a1,python,25,25,0,0
